宁公死后，[E2]袭了官，也养了两个儿子：长名贾敷，至八九岁上便死了，只剩了次子[E1]袭了官，如今一味好道，只爱烧丹炼汞，余者一概不在心上	儿子
宁公死后，[E1]袭了官，也养了两个儿子：长名贾敷，至八九岁上便死了，只剩了次子[E2]袭了官，如今一味好道，只爱烧丹炼汞，余者一概不在心上	父亲
宁公死后，贾代化袭了官，也养了两个儿子：长名[E1]，至八九岁上便死了，只剩了次子[E2]袭了官，如今一味好道，只爱烧丹炼汞，余者一概不在心上	无关系
宁公死后，[E1]化袭了官，也养了两个儿子：长名贾敷，至八九岁上便死了，只剩了次子[E2]袭了官，如今一味好道，只爱烧丹炼汞，余者一概不在心上	无关系
自荣公死后，长子[E2]袭了官，娶的也是金陵世勋史侯家的小姐为妻，生了两个儿子：长子贾赦，次子[E1]	儿子
自荣公死后，长子[E1]袭了官，娶的也是金陵世勋史侯家的小姐为妻，生了两个儿子：长子[E2]，次子贾政	父亲
自荣公死后，长子贾代善袭了官，娶的也是金陵世勋史侯家的小姐为妻，生了两个儿子：长子[E2]，次子[E1]	兄弟
自荣公死后，长子[E1]袭了官，娶的也是金陵世勋史侯家的小姐为妻，生了两个儿子：长子贾赦，次子[E2]	父亲
自荣公死后，长子[E2]袭了官，娶的也是金陵世勋史侯家的小姐为妻，生了两个儿子：长子[E1]，次子贾政	儿子
自荣公死后，长子[E1]善袭了官，娶的也是金陵世勋史侯家的小姐为妻，生了两个儿子：长子[E2]，次子贾政	无关系
自荣公死后，长子[E1]善[E2]官，娶的也是金陵世勋史侯家的小姐为妻，生了两个儿子：长子贾赦，次子贾政	无关系
自荣公死后，长子贾代善[E1]官，娶的也是金陵世勋史侯家的小姐为妻，生了两个儿子：长子贾赦，次子[E2]	无关系
自荣公死后，长子[E1]善袭了官，娶的也是金陵世勋史侯家的小姐为妻，生了两个儿子：长子贾赦，次子[E2]	无关系
自荣公死后，长子贾代善[E1]官，娶的也是金陵世勋史侯家的小姐为妻，生了两个儿子：长子[E2]，次子贾政	无关系
如今代善早已去世，太夫人尚在，长子[E2]袭着官；次子[E1]，自幼酷喜读书，祖父最疼，原欲以科甲出身的，不料代善临终时遗本一上，皇上因恤先臣，即时令长子袭官外，问还有几子，立刻引见，遂额外赐了这政老爹一个主事之衔，令其入部习学，如今现已升了员外郎了	兄弟
如今代善早已去世，太夫人尚在，长子贾赦[E1]官；次子贾政，自幼酷喜读书，祖父最疼，原欲以科甲出身的，不料代善临终时遗本一上，皇上因恤先臣，即时令长子[E2]外，问还有几子，立刻引见，遂额外赐了这政老爹一个主事之衔，令其入部习学，如今现已升了员外郎了	无关系
却说雨村忙回头看时，不是别人，乃是当日同僚一案参革的号张如圭者	老师
——此即冷子兴所云之史氏太君，[E2][E1]之母也	兄弟
”黛玉虽不识，也曾听见母亲说过，大舅贾赦之子[E1]，娶的就是二舅母王氏之内侄女，自幼假充男儿教养的，学名[E2]	丈夫
”黛玉虽不识，也曾听见母亲说过，大舅贾赦之子[E2]，娶的就是二舅母王氏之内侄女，自幼假充男儿教养的，学名[E1]	妻
”黛玉虽不识，也曾听见母亲说过，大舅[E2]之子[E1]，娶的就是二舅母王氏之内侄女，自幼假充男儿教养的，学名王熙凤	儿子
”黛玉虽不识，也曾听见母亲说过，大舅[E1]之子[E2]，娶的就是二舅母王氏之内侄女，自幼假充男儿教养的，学名王熙凤	父亲
”黛玉虽不识，也曾听见母亲说过，大舅[E1]之子贾琏，娶的就是二舅母王氏之内侄女，自幼假充男儿教养的，学名[E2]	无关系
一时进入正室，早有许多盛妆丽服之姬妾丫鬟迎着，[E1]让黛玉坐了，一面命人到外面书房去请[E2]	妻
一时进入正室，早有许多盛妆丽服之姬妾丫鬟迎着，[E2]让黛玉坐了，一面命人到外面书房去请[E1]	丈夫
[E1]遂携黛玉穿过一个东西穿堂，便是[E2]的后院了	小儿媳
[E2]之妻李氏捧饭，熙凤安箸，[E1]进羹	母亲
[E1]之妻李氏捧饭，熙凤安箸，[E2]进羹	儿子
次日起来，省过[E2]，因往[E1]处来，正值[E1]与熙凤在一处拆金陵来的书信看，又有[E1]之兄嫂处遣了两个媳妇来说话的	小儿媳
”喜的[E2]忙带了女媳人等，接出大厅，将[E1]等接了进去	姐妹
”喜的[E1]忙带了女媳人等，接出大厅，将[E2]等接了进去	姐妹
薛蟠已拜见过[E1]，贾琏又引着拜见了[E2]，贾珍等	兄弟
薛蟠已拜见过贾政，[E1]又引着拜见了[E2]，贾珍等	儿子
薛蟠已拜见过贾政，[E2]又引着拜见了[E1]，贾珍等	父亲
薛蟠已拜见过[E1]，[E2]又引着拜见了贾赦，贾珍等	无关系
薛蟠已拜见过[E1]，贾琏又引着拜见了贾赦，[E2]等	无关系
[E1]已拜见过[E2]，贾琏又引着拜见了贾赦，贾珍等	无关系
[E1]便使人上来对[E2]说：“姨太太已有了春秋，外甥年轻不知世路，在外住着恐有人生事	丈夫
[E2]便使人上来对[E1]说：“姨太太已有了春秋，外甥年轻不知世路，在外住着恐有人生事	妻
”[E1]未及留，[E2]也就遣人来说：“请姨太太就在这里住下，大家亲密些”等语	小儿媳
每日或饭后，或晚间，[E1]便过来，或与贾母闲谈，或与[E2]相叙	姐妹
每日或饭后，或晚间，[E2]便过来，或与贾母闲谈，或与[E1]相叙	姐妹
每日或饭后，或晚间，薛姨妈便过来，或与[E2]闲谈，或与[E1]相叙	小儿媳
每日或饭后，或晚间，[E1]便过来，或与[E2]闲谈，或与王夫人相叙	无关系
如今且说[E1]自在荣府以来，[E2]万般怜爱，寝食起居一如宝玉，把那迎春、探春、惜春三个孙女儿倒且靠后了；就是宝玉黛玉二人的亲密友爱，也较别人不同，日则同行同坐，夜则同止同息，真是言和意顺，略无参商	外孙女
如今且说[E2]自在荣府以来，[E1]万般怜爱，寝食起居一如宝玉，把那迎春、探春、惜春三个孙女儿倒且靠后了；就是宝玉黛玉二人的亲密友爱，也较别人不同，日则同行同坐，夜则同止同息，真是言和意顺，略无参商	外祖母
因东边宁府花园内梅花盛开，[E1]之妻尤氏乃治酒，请贾母、邢夫人、王夫人等赏花，是日先携了[E2]之妻，二人来面请	父亲
因东边宁府花园内梅花盛开，[E2]之妻[E1]乃治酒，请贾母、邢夫人、王夫人等赏花，是日先携了贾蓉之妻，二人来面请	妻
因东边宁府花园内梅花盛开，贾珍之妻尤氏乃治酒，请[E2]、[E1]、王夫人等赏花，是日先携了贾蓉之妻，二人来面请	大儿媳
因东边宁府花园内梅花盛开，贾珍之妻尤氏乃治酒，请[E2]、邢夫人、[E1]等赏花，是日先携了贾蓉之妻，二人来面请	小儿媳
因东边宁府花园内梅花盛开，贾珍之妻尤氏乃治酒，请[E1]、[E2]、王夫人等赏花，是日先携了贾蓉之妻，二人来面请	婆婆
因东边宁府花园内梅花盛开，[E1]之妻[E2]乃治酒，请贾母、邢夫人、王夫人等赏花，是日先携了贾蓉之妻，二人来面请	丈夫
因东边宁府花园内梅花盛开，[E2]之妻尤氏乃治酒，请贾母、邢夫人、王夫人等赏花，是日先携了[E1]之妻，二人来面请	儿子
因东边宁府花园内梅花盛开，贾珍之妻[E1]乃治酒，请贾母、邢夫人、王夫人等赏花，是日先携了[E2]之妻，二人来面请	无关系
因东边宁府花园内梅花盛开，贾珍之妻[E1]乃治酒，请贾母、[E2]、王夫人等赏花，是日先携了贾蓉之妻，二人来面请	无关系
因东边宁府花园内梅花盛开，[E1]之妻尤氏乃治酒，请贾母、[E2]、王夫人等赏花，是日先携了贾蓉之妻，二人来面请	无关系
因东边宁府花园内梅花盛开，贾珍之妻[E1]乃治酒，请[E2]、邢夫人、王夫人等赏花，是日先携了贾蓉之妻，二人来面请	无关系
因东边宁府花园内梅花盛开，[E1]之妻尤氏乃治酒，请贾母、邢夫人、[E2]等赏花，是日先携了贾蓉之妻，二人来面请	无关系
因东边宁府花园内梅花盛开，贾珍之妻尤氏乃治酒，请贾母、[E1]、[E2]等赏花，是日先携了贾蓉之妻，二人来面请	无关系
因东边宁府花园内梅花盛开，贾珍之妻尤氏乃治酒，请[E1]、邢夫人、王夫人等赏花，是日先携了[E2]之妻，二人来面请	无关系
话说宝玉和凤姐回家，见过众人，宝玉便回明贾母要约[E1]上家塾之事，自己也有个伴读的朋友，正好发奋；又着实称赞[E1]人品行事，最是可人怜爱的	朋友
话说宝玉和凤姐回家，见过众人，宝玉便回明贾母要约秦钟上家塾之事，自己也有个伴读的朋友，正好发奋；又着实称赞秦钟人品行事，最是可人怜爱的	丈夫
话说宝玉和凤姐回家，见过众人，宝玉便回明贾母要约秦钟上家塾之事，自己也有个伴读的朋友，正好发奋；又着实称赞秦钟人品行事，最是可人怜爱的	妻
话说宝玉和凤姐回家，见过众人，宝玉便回明[E1]要约秦钟上家塾之事，自己也有个伴读的朋友，正好发奋；又着实称赞秦钟人品行事，最是可人怜爱的	奶奶
话说宝玉和凤姐回家，见过众人，宝玉便回明[E1]要约[E2]上家塾之事，自己也有个伴读的朋友，正好发奋；又着实称赞[E2]人品行事，最是可人怜爱的	无关系
[E1]本好清净，见[E2]回来也就回来了	小儿媳
[E2]见秦钟形容标致，举止温柔，堪陪宝玉读书，心中十分喜欢，便留茶留饭，又叫人带去见[E1]等	小儿媳
[E1]见[E2]形容标致，举止温柔，堪陪宝玉读书，心中十分喜欢，便留茶留饭，又叫人带去见王夫人等	无关系
[E2]却于五十三岁上得了[E1]，今年十二岁了；因去岁业师回南，在家温习旧课，正要与贾亲家商议附往他家塾中去	儿子
[E1]却于五十三岁上得了[E2]，今年十二岁了；因去岁业师回南，在家温习旧课，正要与贾亲家商议附往他家塾中去	父亲
秦邦业却于五十三岁上得了[E1]，今年十二岁了；因去岁业师回南，在家温习旧课，正要与[E2]家商议附往他家塾中去	无关系
到了宁府，进了车门，到了东边小角门前下了车，进去见了[E2]之妻[E1]	妻
到了宁府，进了车门，到了东边小角门前下了车，进去见了[E1]之妻[E2]	丈夫
”正是说话间，[E2]从外进来，见了金氏，便向[E1]问道：“这不是璜大奶奶么	妻
”正是说话间，[E1]从外进来，见了金氏，便向[E2]问道：“这不是璜大奶奶么	丈夫
[E2]向[E1]说道：“让这大妹妹吃了饭去	妻
[E1]向[E2]说道：“让这大妹妹吃了饭去	丈夫
况且[E2][E1]又待的很好，反转怒为喜，又说了一会子话儿，方家去了	妻
况且[E1][E2]又待的很好，反转怒为喜，又说了一会子话儿，方家去了	丈夫
金氏去后，[E2]方过来坐下，问[E1]道：“今日他来，有什么说的事情么	妻
金氏去后，[E1]方过来坐下，问[E2]道：“今日他来，有什么说的事情么	丈夫
”[E2]转身复进去，回了[E1]尤氏的话，方出来叫了来升来，吩咐他预备两日的筵席的话	父亲
”贾蓉转身复进去，回了[E2][E1]的话，方出来叫了来升来，吩咐他预备两日的筵席的话	妻
”[E1]转身复进去，回了[E2]尤氏的话，方出来叫了来升来，吩咐他预备两日的筵席的话	儿子
”贾蓉转身复进去，回了[E1][E2]的话，方出来叫了来升来，吩咐他预备两日的筵席的话	丈夫
”[E1]转身复进去，回了贾珍[E2]的话，方出来叫了来升来，吩咐他预备两日的筵席的话	无关系
于是[E2]送了先生去了，方将这药方子并脉案都给[E1]看了，说的话也都回了[E1]并尤氏了	父亲
于是贾蓉送了先生去了，方将这药方子并脉案都给[E2]看了，说的话也都回了[E2]并[E1]了	妻
于是[E1]送了先生去了，方将这药方子并脉案都给[E2]看了，说的话也都回了[E2]并尤氏了	儿子
于是贾蓉送了先生去了，方将这药方子并脉案都给[E1]看了，说的话也都回了[E1]并[E2]了	丈夫
于是[E1]送了先生去了，方将这药方子并脉案都给贾珍看了，说的话也都回了贾珍并[E2]了	无关系
[E1]向[E2]说道：“从来大夫不象他说的这么痛快，想必用的药也不错	妻
[E2]向[E1]说道：“从来大夫不象他说的这么痛快，想必用的药也不错	丈夫
话说是日贾敬的寿辰，[E1]先将上等可吃的东西，稀奇些的果品，装了十六大捧盒，着[E2]带领家下人等与贾敬送去，向[E2]说道：“你留神看太爷喜欢不喜欢，你就行了礼来	父亲
话说是日贾敬的寿辰，[E2]先将上等可吃的东西，稀奇些的果品，装了十六大捧盒，着[E1]带领家下人等与贾敬送去，向[E1]说道：“你留神看太爷喜欢不喜欢，你就行了礼来	儿子
话说是日[E2]的寿辰，[E1]先将上等可吃的东西，稀奇些的果品，装了十六大捧盒，着贾蓉带领家下人等与[E2]送去，向贾蓉说道：“你留神看太爷喜欢不喜欢，你就行了礼来	儿子
话说是日[E1]的寿辰，[E2]先将上等可吃的东西，稀奇些的果品，装了十六大捧盒，着贾蓉带领家下人等与[E1]送去，向贾蓉说道：“你留神看太爷喜欢不喜欢，你就行了礼来	父亲
话说是日[E1]的寿辰，贾珍先将上等可吃的东西，稀奇些的果品，装了十六大捧盒，着[E2]带领家下人等与[E1]送去，向[E2]说道：“你留神看太爷喜欢不喜欢，你就行了礼来	无关系
次后邢夫人、王夫人、凤姐儿、宝玉都来了，[E2]并[E1]接了进去	妻
次后邢夫人、王夫人、凤姐儿、宝玉都来了，[E1]并[E2]接了进去	丈夫
次后[E1]、王夫人、凤姐儿、宝玉都来了，[E2]并尤氏接了进去	无关系
次后邢夫人、[E1]、凤姐儿、宝玉都来了，[E2]并尤氏接了进去	无关系
[E2][E1]二人亲自递了茶，因说道：“老太太原是老祖宗，我父亲又是侄儿，这样日子，原不敢请他老人家；但是这个时候，天气正凉爽，满园的菊花又盛开，请老祖宗过来散散闷，看着众儿孙热闹热闹，是这个意思	妻
[E1][E2]二人亲自递了茶，因说道：“老太太原是老祖宗，我父亲又是侄儿，这样日子，原不敢请他老人家；但是这个时候，天气正凉爽，满园的菊花又盛开，请老祖宗过来散散闷，看着众儿孙热闹热闹，是这个意思	丈夫
[E1]率同众姬妾并家下婆子媳妇们方送出来，[E2]率领众子侄都在车旁侍立，等候着呢，见了邢夫人、王夫人道：“二位婶子明日还过来逛逛	妻
[E2]率同众姬妾并家下婆子媳妇们方送出来，[E1]率领众子侄都在车旁侍立，等候着呢，见了邢夫人、王夫人道：“二位婶子明日还过来逛逛	丈夫
尤氏率同众姬妾并家下婆子媳妇们方送出来，[E1]率领众子侄都在车旁侍立，等候着呢，见了[E2]、王夫人道：“二位婶子明日还过来逛逛	无关系
尤氏率同众姬妾并家下婆子媳妇们方送出来，[E1]率领众子侄都在车旁侍立，等候着呢，见了邢夫人、[E2]道：“二位婶子明日还过来逛逛	无关系
[E1]，尤氏，[E2]好不焦心	父亲
[E2]，[E1]，贾蓉好不焦心	妻
[E2]，尤氏，[E1]好不焦心	儿子
[E1]，[E2]，贾蓉好不焦心	丈夫
贾珍，[E1]，[E2]好不焦心	无关系
到交节的那几日，[E2]、[E1]、凤姐儿日日差人去看秦氏，回来的人都说：“这几日也没见添病，也不见甚好	小儿媳
”[E1]向[E2]说：“这个症候，遇着这样大节不添病，就有好大的指望了	小儿媳
当下贾家众人齐来吊问，荣国府[E2]赠银二十两，[E1]亦是二十两，宁国府贾珍亦有二十两，别者族中贫富不等，或三两五两，不可胜数	兄弟
当下贾家众人齐来吊问，荣国府[E1]赠银二十两，贾政亦是二十两，宁国府[E2]亦有二十两，别者族中贫富不等，或三两五两，不可胜数	无关系
谁知这年冬底，[E1]的书信寄来，却为身染重疾，写书特来接[E2]回去	父亲
谁知这年冬底，[E2]的书信寄来，却为身染重疾，写书特来接[E1]回去	女儿
作速择了日期，贾琏与[E1]辞别了[E2]等，带领仆从，登舟往扬州去了	外孙女
作速择了日期，贾琏与[E2]辞别了[E1]等，带领仆从，登舟往扬州去了	外祖母
作速择了日期，[E1]与林黛玉辞别了[E2]等，带领仆从，登舟往扬州去了	无关系
作速择了日期，[E1]与[E2]辞别了贾母等，带领仆从，登舟往扬州去了	无关系
话说凤姐儿自[E2]送黛玉往扬州去后，心中实在无趣，每到晚间，不过和平儿说笑一回，就胡乱睡了	妻
话说凤姐儿自[E1]送黛玉往扬州去后，心中实在无趣，每到晚间，不过和平儿说笑一回，就胡乱睡了	丈夫
彼时贾代儒、代修、贾敕、贾效、贾敦、[E2]、[E1]、贾琮、贾王扁、贾珩、贾珖、贾琛、贾琼、贾璘、贾蔷、贾菖、贾菱、贾芸、贾芹、贾蓁、贾萍、贾藻、贾蘅、贾芬、贾芳、贾兰、贾菌、贾芝等都来了	兄弟
彼时贾代儒、代修、贾敕、贾效、贾敦、贾赦、贾政、贾琮、贾王扁、[E1]、贾珖、[E2]、贾琼、贾璘、贾蔷、贾菖、贾菱、贾芸、贾芹、贾蓁、贾萍、贾藻、贾蘅、贾芬、贾芳、贾兰、贾菌、贾芝等都来了	无关系
[E2]便命贾琼、贾琛、贾璘，[E1]四个人去陪客，一面吩咐去请钦天监阴阳司来择日，择准停灵七七四十九日，三日后开丧送讣闻	养子
贾珍便命贾琼、贾琛、[E1]，[E2]四个人去陪客，一面吩咐去请钦天监阴阳司来择日，择准停灵七七四十九日，三日后开丧送讣闻	无关系
那[E2]闻得长孙媳死了，因自为早晚就要飞升，如何肯又回家染了红尘，将前功尽弃呢，因此并不在意，只凭[E1]料理	儿子
那[E1]闻得长孙媳死了，因自为早晚就要飞升，如何肯又回家染了红尘，将前功尽弃呢，因此并不在意，只凭[E2]料理	父亲
[E1]因想着[E2]不过是个黉门监，灵幡经榜上写时不好看，便是执事也不多，因此心下甚不自在	父亲
[E2]因想着[E1]不过是个黉门监，灵幡经榜上写时不好看，便是执事也不多，因此心下甚不自在	儿子
[E1]心中打算定了主意，因而趁便就说要与[E2]捐个前程的话	父亲
[E2]心中打算定了主意，因而趁便就说要与[E1]捐个前程的话	儿子
曾祖，原任京营节度使世袭一等神威将军贾代化；祖，乙卯科进士[E1]；父，世袭三品爵威烈将军[E2]	父亲
曾祖，原任京营节度使世袭一等神威将军贾代化；祖，乙卯科进士[E2]；父，世袭三品爵威烈将军[E1]	儿子
曾祖，原任京营节度使世袭一等神威将军[E2]；祖，乙卯科进士[E1]；父，世袭三品爵威烈将军贾珍	儿子
曾祖，原任京营节度使世袭一等神威将军[E1]；祖，乙卯科进士[E2]；父，世袭三品爵威烈将军贾珍	父亲
曾祖，原任京营节度使世袭一等神威将军贾代化；祖，乙卯科进士贾敬；父，世[E1]品爵威烈将军[E2]	无关系
曾祖，原任京营节度使世[E1]等神威将军贾代化；祖，乙卯科进士贾敬；父，世袭三品爵威烈将军[E2]	无关系
曾祖，原任京营节度使世袭一等神威将军贾代化；祖，乙卯科进士[E1]；父，世[E2]品爵威烈将军贾珍	无关系
曾祖，原任京营节度使世[E1]等神威将军贾代化；祖，乙卯科进士[E2]；父，世袭三品爵威烈将军贾珍	无关系
[E1]命[E2]次日换了吉服，领凭回来	父亲
[E2]命[E1]次日换了吉服，领凭回来	儿子
只是[E2]虽然此时心意满足，但里面[E1]又犯了旧疾，不能料理事务，惟恐各诰命来往，亏了礼数，怕人笑话，因此心中不自在	妻
只是[E1]虽然此时心意满足，但里面[E2]又犯了旧疾，不能料理事务，惟恐各诰命来往，亏了礼数，怕人笑话，因此心中不自在	丈夫
因见[E1]犯病，[E2]又过于悲哀，不大进饮食，自己每日从那府中煎了各样细粥，精致小菜，命人送来劝食	妻
因见[E2]犯病，[E1]又过于悲哀，不大进饮食，自己每日从那府中煎了各样细粥，精致小菜，命人送来劝食	丈夫
一时[E2][E1]遣人来劝，凤姐方才止住	妻
一时[E1][E2]遣人来劝，凤姐方才止住	丈夫
贾珍急命前面驻扎，同[E2][E1]三人连忙迎来，以国礼相见	兄弟
[E1]急命前面驻扎，同贾赦[E2]三人连忙迎来，以国礼相见	无关系
刚至城门前，又有[E2]、[E1]、贾珍等诸同僚属下各家祭棚接祭，一一的谢过，然后出城，竟奔铁槛寺大路行来	兄弟
刚至城门前，又有[E1]、贾政、[E2]等诸同僚属下各家祭棚接祭，一一的谢过，然后出城，竟奔铁槛寺大路行来	无关系
彼时[E1]带[E2]来到诸长辈前，让坐轿上马，因而贾赦一辈的各自上了车轿，[E1]一辈的也将要上马	父亲
彼时[E2]带[E1]来到诸长辈前，让坐轿上马，因而贾赦一辈的各自上了车轿，[E2]一辈的也将要上马	儿子
彼时[E1]带贾蓉来到诸长辈前，让坐轿上马，因而[E2]一辈的各自上了车轿，[E1]一辈的也将要上马	无关系
彼时贾珍带[E1]来到诸长辈前，让坐轿上马，因而[E2]一辈的各自上了车轿，贾珍一辈的也将要上马	无关系
凤姐儿因记挂着宝玉，怕他在郊外纵性逞强，不服家人的话，[E1]管不着这些小事，惟恐有个失闪，难见[E2]，因此便命小厮来唤他	儿子
当下和尚工课已完，奠过茶饭，[E1]便命[E2]请凤姐歇息	父亲
当下和尚工课已完，奠过茶饭，[E2]便命[E1]请凤姐歇息	儿子
”那[E1]自幼在荣府走动，无人不识，因常与宝玉[E2]顽笑	暧昧
至次日一早，便有[E2][E1]打发了人来看宝玉，又命多穿两件衣服，无事宁可回去	小儿媳
偏那[E2]秉赋最弱，因在郊外受了些风霜，又与[E1]偷期绻缱，未免失于调养，回来时便咳嗽伤风，懒进饮食，大有不胜之态，遂不敢出门，只在家中养息	暧昧
”唬的[E2][E1]等一干人不知是何消息，忙止了戏文，撤去酒席，摆了香案，启中门跪接	兄弟
那时贾母正心神不定，在大堂廊下伫立，那邢夫人、[E2]、尤氏、李纨、凤姐、迎春姊妹以及[E1]等皆在一处，听如此信至，贾母便唤进赖大来细问端的	姐妹
那时[E2]正心神不定，在大堂廊下伫立，那[E1]、王夫人、尤氏、李纨、凤姐、迎春姊妹以及薛姨妈等皆在一处，听如此信至，[E2]便唤进赖大来细问端的	大儿媳
那时[E2]正心神不定，在大堂廊下伫立，那邢夫人、[E1]、尤氏、李纨、凤姐、迎春姊妹以及薛姨妈等皆在一处，听如此信至，[E2]便唤进赖大来细问端的	小儿媳
那时贾母正心神不定，在大堂廊下伫立，那邢夫人、[E1]、尤氏、李纨、凤姐、迎春姊妹以及[E2]等皆在一处，听如此信至，贾母便唤进赖大来细问端的	姐妹
那时[E1]正心神不定，在大堂廊下伫立，那[E2]、王夫人、尤氏、李纨、凤姐、迎春姊妹以及薛姨妈等皆在一处，听如此信至，[E1]便唤进赖大来细问端的	婆婆
那时[E1]正心神不定，在大堂廊下伫立，那邢夫人、王夫人、[E2]、李纨、凤姐、迎春姊妹以及薛姨妈等皆在一处，听如此信至，[E1]便唤进赖大来细问端的	无关系
那时贾母正心神不定，在大堂廊下伫立，那[E1]、王夫人、尤氏、李纨、凤姐、迎春姊妹以及薛姨妈等皆在一处，听如此信至，贾母便唤进[E2]来细问端的	无关系
那时贾母正心神不定，在大堂廊下伫立，那[E1]、王夫人、[E2]、李纨、凤姐、迎春姊妹以及薛姨妈等皆在一处，听如此信至，贾母便唤进赖大来细问端的	无关系
那时贾母正心神不定，在大堂廊下伫立，那邢夫人、王夫人、[E1]、李纨、凤姐、迎春姊妹以及[E2]等皆在一处，听如此信至，贾母便唤进赖大来细问端的	无关系
那时贾母正心神不定，在大堂廊下伫立，那[E1]、[E2]、尤氏、李纨、凤姐、迎春姊妹以及薛姨妈等皆在一处，听如此信至，贾母便唤进赖大来细问端的	无关系
[E2]带领[E1]、王夫人、尤氏，一共四乘大轿入朝	大儿媳
[E1]带领[E2]、王夫人、尤氏，一共四乘大轿入朝	婆婆
[E2]带领邢夫人、[E1]、尤氏，一共四乘大轿入朝	小儿媳
[E1]带领邢夫人、王夫人、[E2]，一共四乘大轿入朝	无关系
贾母带领[E1]、王夫人、[E2]，一共四乘大轿入朝	无关系
贾母带领[E1]、[E2]、尤氏，一共四乘大轿入朝	无关系
贾赦，[E1]亦换了朝服，带领[E2]、贾蔷奉侍贾母大轿前往	父亲
贾赦，[E2]亦换了朝服，带领贾蓉、[E1]奉侍贾母大轿前往	养子
[E2]，贾珍亦换了朝服，带领贾蓉、贾蔷奉侍[E1]大轿前往	母亲
[E1]，贾珍亦换了朝服，带领贾蓉、贾蔷奉侍[E2]大轿前往	儿子
贾赦，[E2]亦换了朝服，带领[E1]、贾蔷奉侍贾母大轿前往	儿子
[E1]，贾珍亦换了朝服，带领[E2]、贾蔷奉侍贾母大轿前往	无关系
贾赦，贾珍亦换了朝服，带领贾蓉、[E1]奉侍[E2]大轿前往	无关系
贾赦，贾珍亦换了朝服，带领[E1]、贾蔷奉侍[E2]大轿前往	无关系
[E1]，[E2]亦换了朝服，带领贾蓉、贾蔷奉侍贾母大轿前往	无关系
贾赦，贾珍亦换了朝服，带领[E1]、[E2]奉侍贾母大轿前往	无关系
次早贾琏起来，见过[E2][E1]，便往宁府中来，合同老管事的人等，并几位世交门下清客相公，审察两府地方，缮画省亲殿宇，一面察度办理人丁	兄弟
次早[E1]起来，见过[E2]贾政，便往宁府中来，合同老管事的人等，并几位世交门下清客相公，审察两府地方，缮画省亲殿宇，一面察度办理人丁	儿子
次早[E2]起来，见过[E1]贾政，便往宁府中来，合同老管事的人等，并几位世交门下清客相公，审察两府地方，缮画省亲殿宇，一面察度办理人丁	父亲
次早[E1]起来，见过贾赦[E2]，便往宁府中来，合同老管事的人等，并几位世交门下清客相公，审察两府地方，缮画省亲殿宇，一面察度办理人丁	无关系
[E1]不惯于俗务，只凭[E2]、贾珍、贾琏、赖大、来升、林之孝、吴新登、詹光、程日兴等几人安插摆布	兄弟
贾政不惯于俗务，只凭[E2]、贾珍、[E1]、赖大、来升、林之孝、吴新登、詹光、程日兴等几人安插摆布	儿子
贾政不惯于俗务，只凭[E1]、贾珍、[E2]、赖大、来升、林之孝、吴新登、詹光、程日兴等几人安插摆布	父亲
[E1]不惯于俗务，只凭贾赦、贾珍、[E2]、赖大、来升、林之孝、吴新登、詹光、程日兴等几人安插摆布	无关系
贾政不惯于俗务，只凭[E1]、贾珍、贾琏、赖大、来升、[E2]、吴新登、詹光、程日兴等几人安插摆布	无关系
[E1]不惯于俗务，只凭贾赦、[E2]、贾琏、赖大、来升、林之孝、吴新登、詹光、程日兴等几人安插摆布	无关系
[E2]只在家高卧，有芥豆之事，贾珍等或自去回明，或写略节；或有话说，便传呼[E1]，赖大等领命	儿子
[E1]只在家高卧，有芥豆之事，贾珍等或自去回明，或写略节；或有话说，便传呼[E2]，赖大等领命	父亲
贾赦只在家高卧，有芥豆之事，[E1]等或自去回明，或写略节；或有话说，便传呼贾琏，[E2]等领命	无关系
贾赦只在家高卧，有芥豆之事，贾珍等或自去回明，或写略节；或有话说，便传呼[E1]，[E2]等领命	无关系
”[E1]心中也怕[E2]不放心，遂冷笑道：“你这畜生，也竟有不能之时了	儿子
[E1]方略心意宽畅，又请[E2]等进园，色色斟酌，点缀妥当，再无一些遗漏不当之处了	儿子
[E1]等在西街门外，[E2]等在荣府大门外	儿子
[E2]等在西街门外，[E1]等在荣府大门外	母亲
[E1]领合族子侄在西街门外，[E2]领合族女眷在大门外迎接	儿子
[E2]领合族子侄在西街门外，[E1]领合族女眷在大门外迎接	母亲
早飞跑过几个太监来，扶起[E2]、[E1]、王夫人来	大儿媳
早飞跑过几个太监来，扶起[E1]、[E2]、王夫人来	婆婆
早飞跑过几个太监来，扶起[E2]、邢夫人、[E1]来	小儿媳
早飞跑过几个太监来，扶起贾母、[E1]、[E2]来	无关系
礼仪太监二人引[E2]、[E1]等于月台下排班，殿上昭容传谕曰：“免	兄弟
贾妃满眼垂泪，方彼此上前厮见，一手搀[E2]，一手搀[E1]，三个人满心里皆有许多话，只是俱说不出，只管呜咽对泣	小儿媳
[E1]满眼垂泪，方彼此上前厮见，一手搀[E2]，一手搀王夫人，三个人满心里皆有许多话，只是俱说不出，只管呜咽对泣	无关系
[E2]、李纨、[E1]、迎、探、惜三姊妹等，俱在旁围绕，垂泪无言	儿媳
[E1]、李纨、[E2]、迎、探、惜三姊妹等，俱在旁围绕，垂泪无言	婆婆
半日，贾妃方忍悲强笑，安慰[E2]、[E1]道：“当日既送我到那不得见人的去处，好容易今日回家娘儿们一会，不说说笑笑，反倒哭起来	小儿媳
”[E2]便知是赐[E1]之物，喜的忙接了，命[E1]叩头	相好
”[E2]忙答应了，因命[E1]作《游园》，《惊梦》二出	相好
贾敬，[E2]，[E1]等，每分御制新书二部，宝墨二匣，金，银爵各二只，表礼按前	兄弟
[E1]，贾赦，[E2]等，每分御制新书二部，宝墨二匣，金，银爵各二只，表礼按前	无关系
外表礼二十四端，清钱一百串，是赐与[E2]、[E1]及诸姊妹房中奶娘众丫鬟的	小儿媳
[E1]，贾琏，贾环，[E2]等，皆是表礼一分，金锞一双	父亲
[E2]，贾琏，贾环，[E1]等，皆是表礼一分，金锞一双	儿子
贾珍，贾琏，[E1]，[E2]等，皆是表礼一分，金锞一双	无关系
[E1]，贾琏，[E2]，贾蓉等，皆是表礼一分，金锞一双	无关系
这里诸人好容易将[E2]，[E1]安慰解劝，搀扶出园去了	小儿媳
因他自幼姊妹丛中长大，亲姊妹有元春、探春，伯叔的有迎春、惜春，亲戚中又有[E1]、林黛玉、[E2]等诸人	朋友
因他自幼姊妹丛中长大，亲姊妹有元春、探春，伯叔的有迎春、惜春，亲戚中又有[E1]、[E2]、薛宝钗等诸人	朋友
因他自幼姊妹丛中长大，亲姊妹有元春、探春，伯叔的有迎春、惜春，亲戚中又有史湘云、[E1]、[E2]等诸人	无关系
话说[E1]跑了出来，怕[E2]赶上，宝玉在后忙说：“仔细绊跌了	朋友
那天早又掌灯时分，[E1]、李纨、凤姐、迎、探、惜等都往[E2]这边来，大家闲话了一回，各自归寝	小儿媳
写毕，也往上房来见[E2]，后往[E1]处来	小儿媳
就在[E2]上房排了几席家宴酒席，并无一个外客，只有薛姨妈、[E1]、宝钗是客，余者皆是自己人	孙女
就在贾母上房排了几席家宴酒席，并无一个外客，只有[E1]、[E2]、宝钗是客，余者皆是自己人	无关系
黛玉因让[E1][E2]等	姐妹
黛玉因让[E2][E1]等	姐妹
[E1]朝罢，见[E2]高兴，况在节间，晚上也来承欢取乐	儿子
上面[E2]、[E1]、宝玉一席，下面王夫人、宝钗、黛玉、湘云又一席，迎、探、惜三个又一席	儿子
上面贾母、[E1]、宝玉一席，下面[E2]、宝钗、黛玉、湘云又一席，迎、探、惜三个又一席	丈夫
上面[E2]、贾政、宝玉一席，下面[E1]、宝钗、黛玉、湘云又一席，迎、探、惜三个又一席	小儿媳
上面贾母、[E2]、宝玉一席，下面[E1]、宝钗、黛玉、湘云又一席，迎、探、惜三个又一席	妻
”[E1]忙遣[E2]与两个婆娘将贾兰唤来	父亲
”[E2]忙遣[E1]与两个婆娘将贾兰唤来	儿子
”贾政忙遣[E1]与两个婆娘将[E2]唤来	无关系
”[E1]忙遣贾环与两个婆娘将[E2]唤来	无关系
[E2]亦知因[E1]一人在此所致之故，酒过三巡，便撵[E1]去歇息	儿子
[E1]亦知[E2]之意，撵了自己去后，好让他们姊妹兄弟取乐的	儿子
[E1]已知是荔枝，便故意乱猜别的，罚了许多东西；然后方猜着，也得了[E2]的东西	儿子
[E2]见[E1]如此光景，想到或是他身体劳乏亦未可定，又兼之恐拘束了众姊妹不得高兴顽耍，即对[E1]云：“你竟不必猜了，去安歇罢	儿子
”[E1]一闻此言，连忙答应几个“是”字，又勉强劝了[E2]一回酒，方才退出去了	儿子
且说[E2]见[E1]去了，便道：“你们可自在乐一乐罢	儿子
因[E1]又管理着文官等十二个女戏并行头等事，不大得便，因此[E2]又将贾菖，贾菱唤来监工	养子
因贾蔷又管理着[E1]等十二个女戏并行头等事，不大得便，因此贾珍又将[E2]，贾菱唤来监工	无关系
”[E2]听了，便商之于[E1]	丈夫
”[E1]听了，便商之于[E2]	妻
如今且说[E1]，因在宫中自编大观园题咏之后，忽想起那大观园中景致，自己幸过之后，[E2]必定敬谨封锁，不敢使人进去骚扰，岂不寥落	女儿
如今且说[E2]，因在宫中自编大观园题咏之后，忽想起那大观园中景致，自己幸过之后，[E1]必定敬谨封锁，不敢使人进去骚扰，岂不寥落	父亲
如今且说[E1]春，因在宫中自编大观园题咏之后，忽想起那大观园中景致，自己幸过之后，[E2]必定敬谨封锁，不敢使人进去骚扰，岂不寥落	无关系
却又想到宝玉自幼在姊妹丛中长大，不比别的兄弟，若不命他进去，只怕他冷清了，一时不大畅快，未免[E2][E1]愁虑，须得也命他进园居住方妙	小儿媳
[E1]、王夫人接了这谕，待夏守忠去后，便来回明[E2]，遣人进去各处收拾打扫，安设帘幔床帐	儿子
[E1]、[E2]接了这谕，待夏守忠去后，便来回明贾母，遣人进去各处收拾打扫，安设帘幔床帐	丈夫
贾政、[E1]接了这谕，待夏守忠去后，便来回明[E2]，遣人进去各处收拾打扫，安设帘幔床帐	小儿媳
[E2]、[E1]接了这谕，待夏守忠去后，便来回明贾母，遣人进去各处收拾打扫，安设帘幔床帐	妻
可巧贾政在[E2]房中商议事情，金钏儿、彩云、[E1]、绣鸾、绣凤等众丫鬟都在廊檐底下站着呢，一见宝玉来，都抿着嘴笑	大丫头
可巧贾政在[E2]房中商议事情，金钏儿、[E1]、彩霞、绣鸾、绣凤等众丫鬟都在廊檐底下站着呢，一见宝玉来，都抿着嘴笑	大丫头
可巧[E1]在[E2]房中商议事情，金钏儿、彩云、彩霞、绣鸾、绣凤等众丫鬟都在廊檐底下站着呢，一见宝玉来，都抿着嘴笑	丈夫
可巧贾政在[E2]房中商议事情，[E1]儿、彩云、彩霞、绣鸾、绣凤等众丫鬟都在廊檐底下站着呢，一见宝玉来，都抿着嘴笑	大丫环
可巧[E2]在[E1]房中商议事情，金钏儿、彩云、彩霞、绣鸾、绣凤等众丫鬟都在廊檐底下站着呢，一见宝玉来，都抿着嘴笑	妻
可巧[E1]在王夫人房中商议事情，[E2]、彩云、彩霞、绣鸾、绣凤等众丫鬟都在廊檐底下站着呢，一见宝玉来，都抿着嘴笑	无关系
可巧贾政在[E1]房中商议事情，[E2]、彩云、彩霞、绣鸾、绣凤等众丫鬟都在廊檐底下站着呢，一见宝玉来，都抿着嘴笑	无关系
可巧贾政在王夫人房中商议事情，[E1]、[E2]、彩霞、绣鸾、绣凤等众丫鬟都在廊檐底下站着呢，一见宝玉来，都抿着嘴笑	无关系
可巧贾政在王夫人房中商议事情，[E1]、彩云、[E2]、绣鸾、绣凤等众丫鬟都在廊檐底下站着呢，一见宝玉来，都抿着嘴笑	无关系
可巧贾政在王夫人房中商议事情，金钏儿、[E1]、[E2]、绣鸾、绣凤等众丫鬟都在廊檐底下站着呢，一见宝玉来，都抿着嘴笑	无关系
原来[E1]和[E2]都在里间呢	丈夫
原来[E2]和[E1]都在里间呢	妻
只见[E2]和王夫人对面坐在炕上说话，地下一溜椅子，迎春、探春、惜春、[E1]四个人都坐在那里	儿子
只见[E1]和王夫人对面坐在炕上说话，地下一溜椅子，迎春、探春、惜春、[E2]四个人都坐在那里	父亲
只见[E1]和[E2]对面坐在炕上说话，地下一溜椅子，迎春、探春、惜春、贾环四个人都坐在那里	丈夫
只见[E2]和[E1]对面坐在炕上说话，地下一溜椅子，迎春、探春、惜春、贾环四个人都坐在那里	妻
只见贾政和[E1]对面坐在炕上说话，地下一溜椅子，迎春、探春、惜春、[E2]四个人都坐在那里	无关系
[E2]一举目，见宝玉站在跟前，神彩飘逸，秀色夺人；看看[E1]，人物委琐，举止荒疏；忽又想起贾珠来，再看看王夫人只有这一个亲生的儿子，素爱如珍，自己的胡须将已苍白：因这几件上，把素日嫌恶处分宝玉之心不觉减了八九	儿子
[E2]一举目，见宝玉站在跟前，神彩飘逸，秀色夺人；看看贾环，人物委琐，举止荒疏；忽又想起[E1]来，再看看王夫人只有这一个亲生的儿子，素爱如珍，自己的胡须将已苍白：因这几件上，把素日嫌恶处分宝玉之心不觉减了八九	儿子
[E1]一举目，见宝玉站在跟前，神彩飘逸，秀色夺人；看看[E2]，人物委琐，举止荒疏；忽又想起贾珠来，再看看王夫人只有这一个亲生的儿子，素爱如珍，自己的胡须将已苍白：因这几件上，把素日嫌恶处分宝玉之心不觉减了八九	父亲
贾政一举目，见宝玉站在跟前，神彩飘逸，秀色夺人；看看贾环，人物委琐，举止荒疏；忽又想起[E2]来，再看看[E1]只有这一个亲生的儿子，素爱如珍，自己的胡须将已苍白：因这几件上，把素日嫌恶处分宝玉之心不觉减了八九	母亲
[E1]一举目，见宝玉站在跟前，神彩飘逸，秀色夺人；看看贾环，人物委琐，举止荒疏；忽又想起贾珠来，再看看[E2]只有这一个亲生的儿子，素爱如珍，自己的胡须将已苍白：因这几件上，把素日嫌恶处分宝玉之心不觉减了八九	丈夫
[E1]一举目，见宝玉站在跟前，神彩飘逸，秀色夺人；看看贾环，人物委琐，举止荒疏；忽又想起[E2]来，再看看王夫人只有这一个亲生的儿子，素爱如珍，自己的胡须将已苍白：因这几件上，把素日嫌恶处分宝玉之心不觉减了八九	父亲
[E2]一举目，见宝玉站在跟前，神彩飘逸，秀色夺人；看看贾环，人物委琐，举止荒疏；忽又想起贾珠来，再看看[E1]只有这一个亲生的儿子，素爱如珍，自己的胡须将已苍白：因这几件上，把素日嫌恶处分宝玉之心不觉减了八九	妻
贾政一举目，见宝玉站在跟前，神彩飘逸，秀色夺人；看看贾环，人物委琐，举止荒疏；忽又想起[E1]来，再看看[E2]只有这一个亲生的儿子，素爱如珍，自己的胡须将已苍白：因这几件上，把素日嫌恶处分宝玉之心不觉减了八九	儿子
贾政一举目，见宝玉站在跟前，神彩飘逸，秀色夺人；看看[E1]，人物委琐，举止荒疏；忽又想起贾珠来，再看看[E2]只有这一个亲生的儿子，素爱如珍，自己的胡须将已苍白：因这几件上，把素日嫌恶处分宝玉之心不觉减了八九	无关系
”[E2]见[E1]不自在了，便替宝玉掩饰道：“是老太太起的	丈夫
”[E1]见[E2]不自在了，便替宝玉掩饰道：“是老太太起的	妻
两人正计较，就有[E1]遣人来回[E2]说：“二月二十二日子好，哥儿姐儿们好搬进去的	儿子
”一边说，一边催他穿了衣服，同[E1]往前面来见[E2]	丫头
见了[E1]，不过是偶感些风寒，先述了[E2]问的话，然后自己请了安	儿子
见了[E2]，不过是偶感些风寒，先述了[E1]问的话，然后自己请了安	母亲
[E1]先站起来回了[E2]话，次后便唤人来：“带哥儿进去太太屋里坐着	儿子
[E2]先站起来回了[E1]话，次后便唤人来：“带哥儿进去太太屋里坐着	母亲
[E1]见了他来，先倒站了起来，请过[E2]安，宝玉方请安	大儿媳
[E2]见了他来，先倒站了起来，请过[E1]安，宝玉方请安	婆婆
宝玉去辞[E1]，同姊妹们一同回家，见过[E2]、王夫人等，各自回房安息	儿子
宝玉去辞贾赦，同姊妹们一同回家，见过[E2]、[E1]等，各自回房安息	小儿媳
宝玉去辞[E2]，同姊妹们一同回家，见过[E1]、王夫人等，各自回房安息	母亲
宝玉去辞[E1]，同姊妹们一同回家，见过贾母、[E2]等，各自回房安息	无关系
这日晚上，从北静王府里回来，见过[E2]、[E1]等，回至园内，换了衣服，正要洗澡	小儿媳
展眼过了一日，原来次日就是王子腾夫人的寿诞，那里原打发人来请[E2][E1]的，[E1]见[E2]不自在，也便不去了	小儿媳
展眼过了一日，原来次日就是[E1]的寿诞，那里原打发人来请[E2]王夫人的，王夫人见[E2]不自在，也便不去了	无关系
一时又叫彩云倒杯茶来，一时又叫[E1]来剪剪蜡花，一时又说[E2]挡了灯影	妹妹
一时又叫彩云倒杯茶来，一时又叫[E2]来剪剪蜡花，一时又说[E1]挡了灯影	姐姐
一时又叫[E1]倒杯茶来，一时又叫玉钏儿来剪剪蜡花，一时又说[E2]挡了灯影	无关系
一时又叫[E1]倒杯茶来，一时又叫[E2]来剪剪蜡花，一时又说金钏儿挡了灯影	无关系
宝玉听说便下来，在[E2]身后倒下，又叫[E1]来替他拍着	大丫头
”一句话提醒了王夫人，那王夫人不骂[E2]，便叫过[E1]来骂道：“养出这样黑心不知道理下流种子来，也不管管	母亲
”一句话提醒了王夫人，那王夫人不骂[E1]，便叫过[E2]来骂道：“养出这样黑心不知道理下流种子来，也不管管	儿子
”一句话提醒了[E1]，那[E1]不骂[E2]，便叫过赵姨娘来骂道：“养出这样黑心不知道理下流种子来，也不管管	无关系
”一句话提醒了[E1]，那[E1]不骂贾环，便叫过[E2]来骂道：“养出这样黑心不知道理下流种子来，也不管管	无关系
那[E1]素日虽然常怀嫉妒之心，不忿凤姐宝玉两个，也不敢露出来；如今[E2]又生了事，受这场恶气，不但吞声承受，而且还要走去替宝玉收拾	母亲
那[E2]素日虽然常怀嫉妒之心，不忿凤姐宝玉两个，也不敢露出来；如今[E1]又生了事，受这场恶气，不但吞声承受，而且还要走去替宝玉收拾	儿子
[E1]看了，又是心疼，又怕明日[E2]问怎么回答，急的又把赵姨娘数落一顿	小儿媳
[E1]看了，又是心疼，又怕明日贾母问怎么回答，急的又把[E2]数落一顿	无关系
[E1]并丫头们都唬慌了，忙去报知王夫人、[E2]等	外孙女
[E2]并丫头们都唬慌了，忙去报知王夫人、[E1]等	外祖母
林黛玉并丫头们都唬慌了，忙去报知[E1]、[E2]等	小儿媳
[E1]并丫头们都唬慌了，忙去报知[E2]、贾母等	无关系
[E2]、[E1]见了，唬的抖衣而颤，且“儿”一声“肉”一声放声恸哭	小儿媳
于是惊动诸人，连贾赦、邢夫人、贾珍、贾政、贾琏、贾蓉、贾芸、贾萍、[E2]、[E1]并周瑞家的一干家中上上下下里里外外众媳妇丫头等，都来园内看视	儿子
于是惊动诸人，连[E1]、[E2]、贾珍、贾政、贾琏、贾蓉、贾芸、贾萍、薛姨妈、薛蟠并周瑞家的一干家中上上下下里里外外众媳妇丫头等，都来园内看视	丈夫
于是惊动诸人，连贾赦、邢夫人、[E1]、贾政、贾琏、[E2]、贾芸、贾萍、薛姨妈、薛蟠并周瑞家的一干家中上上下下里里外外众媳妇丫头等，都来园内看视	父亲
于是惊动诸人，连[E2]、邢夫人、贾珍、贾政、[E1]、贾蓉、贾芸、贾萍、薛姨妈、薛蟠并周瑞家的一干家中上上下下里里外外众媳妇丫头等，都来园内看视	儿子
于是惊动诸人，连贾赦、邢夫人、贾珍、贾政、贾琏、贾蓉、贾芸、贾萍、[E1]、[E2]并周瑞家的一干家中上上下下里里外外众媳妇丫头等，都来园内看视	母亲
于是惊动诸人，连[E1]、邢夫人、贾珍、贾政、[E2]、贾蓉、贾芸、贾萍、薛姨妈、薛蟠并周瑞家的一干家中上上下下里里外外众媳妇丫头等，都来园内看视	父亲
于是惊动诸人，连[E2]、邢夫人、贾珍、[E1]、贾琏、贾蓉、贾芸、贾萍、薛姨妈、薛蟠并周瑞家的一干家中上上下下里里外外众媳妇丫头等，都来园内看视	兄弟
于是惊动诸人，连贾赦、邢夫人、[E2]、贾政、贾琏、[E1]、贾芸、贾萍、薛姨妈、薛蟠并周瑞家的一干家中上上下下里里外外众媳妇丫头等，都来园内看视	儿子
于是惊动诸人，连[E2]、[E1]、贾珍、贾政、贾琏、贾蓉、贾芸、贾萍、薛姨妈、薛蟠并周瑞家的一干家中上上下下里里外外众媳妇丫头等，都来园内看视	妻
于是惊动诸人，连贾赦、邢夫人、贾珍、[E1]、贾琏、贾蓉、贾芸、贾萍、薛姨妈、[E2]并周瑞家的一干家中上上下下里里外外众媳妇丫头等，都来园内看视	无关系
于是惊动诸人，连[E1]、邢夫人、贾珍、贾政、贾琏、[E2]、贾芸、贾萍、薛姨妈、薛蟠并周瑞家的一干家中上上下下里里外外众媳妇丫头等，都来园内看视	无关系
于是惊动诸人，连贾赦、邢夫人、贾珍、贾政、贾琏、贾蓉、贾芸、贾萍、[E1]、薛蟠并[E2]一干家中上上下下里里外外众媳妇丫头等，都来园内看视	无关系
于是惊动诸人，连贾赦、邢夫人、贾珍、贾政、贾琏、[E1]、贾芸、贾萍、薛姨妈、[E2]并周瑞家的一干家中上上下下里里外外众媳妇丫头等，都来园内看视	无关系
于是惊动诸人，连贾赦、[E1]、贾珍、贾政、贾琏、贾蓉、贾芸、[E2]、薛姨妈、薛蟠并周瑞家的一干家中上上下下里里外外众媳妇丫头等，都来园内看视	无关系
于是惊动诸人，连贾赦、邢夫人、贾珍、贾政、贾琏、贾蓉、贾芸、贾萍、薛姨妈、[E1]并[E2]一干家中上上下下里里外外众媳妇丫头等，都来园内看视	无关系
于是惊动诸人，连[E1]、邢夫人、贾珍、贾政、贾琏、贾蓉、贾芸、贾萍、薛姨妈、[E2]并周瑞家的一干家中上上下下里里外外众媳妇丫头等，都来园内看视	无关系
于是惊动诸人，连贾赦、[E1]、贾珍、贾政、贾琏、[E2]、贾芸、贾萍、薛姨妈、薛蟠并周瑞家的一干家中上上下下里里外外众媳妇丫头等，都来园内看视	无关系
于是惊动诸人，连贾赦、[E1]、贾珍、贾政、贾琏、贾蓉、贾芸、贾萍、薛姨妈、[E2]并周瑞家的一干家中上上下下里里外外众媳妇丫头等，都来园内看视	无关系
别人慌张自不必讲，独有[E1]更比诸人忙到十分去：又恐[E2]被人挤倒，又恐薛宝钗被人瞧见，又恐香菱被人臊皮，.. ——知道贾珍等是在女人身上做功夫的，因此忙的不堪	儿子
别人慌张自不必讲，独有薛蟠更比诸人忙到十分去：又恐[E2]被人挤倒，又恐[E1]被人瞧见，又恐香菱被人臊皮，.. ——知道贾珍等是在女人身上做功夫的，因此忙的不堪	女儿
别人慌张自不必讲，独有[E2]更比诸人忙到十分去：又恐[E1]被人挤倒，又恐薛宝钗被人瞧见，又恐香菱被人臊皮，.. ——知道贾珍等是在女人身上做功夫的，因此忙的不堪	母亲
别人慌张自不必讲，独有[E2]更比诸人忙到十分去：又恐薛姨妈被人挤倒，又恐薛宝钗被人瞧见，又恐[E1]被人臊皮，.. ——知道贾珍等是在女人身上做功夫的，因此忙的不堪	妾
别人慌张自不必讲，独有薛蟠更比诸人忙到十分去：又恐[E1]被人挤倒，又恐薛宝钗被人瞧见，又恐[E2]被人臊皮，.. ——知道贾珍等是在女人身上做功夫的，因此忙的不堪	无关系
别人慌张自不必讲，独有[E1]更比诸人忙到十分去：又恐薛姨妈被人挤倒，又恐[E2]被人瞧见，又恐香菱被人臊皮，.. ——知道贾珍等是在女人身上做功夫的，因此忙的不堪	无关系
别人慌张自不必讲，独有薛蟠更比诸人忙到十分去：又恐薛姨妈被人挤倒，又恐[E1]被人瞧见，又恐香菱被人臊皮，.. ——知道[E2]等是在女人身上做功夫的，因此忙的不堪	无关系
别人慌张自不必讲，独有薛蟠更比诸人忙到十分去：又恐薛姨妈被人挤倒，又恐薛宝钗被人瞧见，又恐[E1]被人臊皮，.. ——知道[E2]等是在女人身上做功夫的，因此忙的不堪	无关系
贾母、[E2]、邢夫人[E1]等寸地不离，只围着干哭	姐妹
[E2]、王夫人、[E1]薛姨妈等寸地不离，只围着干哭	大儿媳
[E2]、[E1]、邢夫人薛姨妈等寸地不离，只围着干哭	小儿媳
贾母、[E1]、邢夫人[E2]等寸地不离，只围着干哭	姐妹
[E1]、王夫人、[E2]薛姨妈等寸地不离，只围着干哭	婆婆
贾母、[E1]、[E2]薛姨妈等寸地不离，只围着干哭	无关系
[E1]、王夫人、邢夫人[E2]等寸地不离，只围着干哭	无关系
贾母、王夫人、[E1][E2]等寸地不离，只围着干哭	无关系
此时[E1]、贾政又恐哭坏了[E2]，日夜熬油费火，闹的人口不安，也都没了主意	儿子
此时[E2]、[E1]又恐哭坏了贾母，日夜熬油费火，闹的人口不安，也都没了主意	兄弟
此时贾赦、[E1]又恐哭坏了[E2]，日夜熬油费火，闹的人口不安，也都没了主意	儿子
此时[E2]、贾政又恐哭坏了[E1]，日夜熬油费火，闹的人口不安，也都没了主意	母亲
[E1]见不灵效，着实懊恼，因阻[E2]道：“儿女之数，皆由天命，非人力可强者	兄弟
[E2]、[E1]、贾琏、平儿、袭人这几个人更比诸人哭的忘餐废寝，觅死寻活	小儿媳
贾母、[E1]、[E2]、平儿、袭人这几个人更比诸人哭的忘餐废寝，觅死寻活	无关系
[E1]、[E2]等自是称愿	母亲
[E2]、[E1]等自是称愿	儿子
[E2]在旁听见这些话，心里越发难过，便喝退[E1]，自己上来委婉解劝	妾
”[E2]、[E1]听见这些话，那里还耐得住，便命人去快请进来	小儿媳
[E1]虽不自在，奈[E2]之言如何违拗；想如此深宅，何得听的这样真切，心中亦希罕，命人请了进来	儿子
[E2]、[E1]如得了珍宝一般，旋熬了米汤与他二人吃了，精神渐长，邪祟稍退，一家子才把心放下来	小儿媳
紫鹃[E1]素日知道[E2]的情性：无事闷坐，不是愁眉，便是长叹，且好端端的不知为了什么，常常的便自泪道不干的	丫头
[E1]雪雁素日知道[E2]的情性：无事闷坐，不是愁眉，便是长叹，且好端端的不知为了什么，常常的便自泪道不干的	无关系
正说着，只见[E2]房里的丫头找宝玉[E1]去吃饭	外孙女
正说着，只见[E1]房里的丫头找宝玉[E2]去吃饭	外祖母
一时吃过饭，宝玉一则怕[E2]记挂，二则也记挂着[E1]，忙忙的要茶漱口	外孙女
一时吃过饭，宝玉一则怕[E1]记挂，二则也记挂着[E2]，忙忙的要茶漱口	外祖母
刚洗了脸出来，要往[E2]那里请安去，只见[E1]顶头来了	外孙女
刚洗了脸出来，要往[E1]那里请安去，只见[E2]顶头来了	外祖母
宝钗分明看见，只装看不见，低着头过去了，到了[E1]那里，坐了一回，然后到了[E2]这边，只见宝玉在这里呢	小儿媳
贾母又打发人去请了[E1]，顺路告诉[E2]，要带了他们姊妹去	姐妹
贾母又打发人去请了[E2]，顺路告诉[E1]，要带了他们姊妹去	姐妹
[E2]又打发人去请了薛姨妈，顺路告诉[E1]，要带了他们姊妹去	小儿媳
[E1]又打发人去请了[E2]，顺路告诉王夫人，要带了他们姊妹去	无关系
[E1]因一则身上不好，二则预备着元春有人出来，早已回了不去的，听[E2]如今这样说，笑道：“还是这么高兴	小儿媳
然后[E2]的丫头鸳鸯，鹦鹉，琥珀，珍珠，林黛玉的丫头[E1]，雪雁，春纤，宝钗的丫头莺儿，文杏，迎春的丫头司棋，绣桔，探春的丫头待书，翠墨、惜春的丫头入画、彩屏，薛姨妈的丫头同喜、同贵，外带着香菱，香菱的丫头臻儿、李氏的丫头素云、碧月，凤姐儿的丫头平儿、丰儿、小红，并王夫人两个丫头也要跟了凤姐儿去的金钏、彩云，奶子抱着大姐儿带着巧姐儿另在一车，还有两个丫头，一共又连上各房的老嬷嬷奶娘并跟出门的家人媳妇子，乌压压的占了一街的车	丫头
然后贾母的丫头鸳鸯，鹦鹉，琥珀，珍珠，林黛玉的丫头紫鹃，雪雁，春纤，宝钗的丫头莺儿，文杏，迎春的丫头司棋，绣桔，探春的丫头待书，翠墨、惜春的丫头入画、彩屏，[E1]的丫头同喜、同贵，外带着香菱，香菱的丫头臻儿、李氏的丫头素云、碧月，凤姐儿的丫头平儿、丰儿、小红，并[E2]两个丫头也要跟了凤姐儿去的金钏、彩云，奶子抱着大姐儿带着巧姐儿另在一车，还有两个丫头，一共又连上各房的老嬷嬷奶娘并跟出门的家人媳妇子，乌压压的占了一街的车	姐妹
然后贾母的丫头鸳鸯，鹦鹉，琥珀，珍珠，林黛玉的丫头紫鹃，雪雁，春纤，宝钗的丫头莺儿，文杏，迎春的丫头司棋，绣桔，探春的丫头待书，翠墨、惜春的丫头入画、彩屏，薛姨妈的丫头同喜、同贵，外带着香菱，香菱的丫头臻儿、李氏的丫头素云、碧月，凤姐儿的丫头平儿、丰儿、小红，并[E2]两个丫头也要跟了凤姐儿去的金钏、[E1]，奶子抱着大姐儿带着巧姐儿另在一车，还有两个丫头，一共又连上各房的老嬷嬷奶娘并跟出门的家人媳妇子，乌压压的占了一街的车	大丫头
然后贾母的丫头鸳鸯，鹦鹉，琥珀，珍珠，[E2]的丫头紫鹃，[E1]，春纤，宝钗的丫头莺儿，文杏，迎春的丫头司棋，绣桔，探春的丫头待书，翠墨、惜春的丫头入画、彩屏，薛姨妈的丫头同喜、同贵，外带着香菱，香菱的丫头臻儿、李氏的丫头素云、碧月，凤姐儿的丫头平儿、丰儿、小红，并王夫人两个丫头也要跟了凤姐儿去的金钏、彩云，奶子抱着大姐儿带着巧姐儿另在一车，还有两个丫头，一共又连上各房的老嬷嬷奶娘并跟出门的家人媳妇子，乌压压的占了一街的车	丫头
然后[E2]的丫头鸳鸯，鹦鹉，琥珀，珍珠，林黛玉的丫头紫鹃，雪雁，春纤，宝钗的丫头莺儿，文杏，迎春的丫头司棋，绣桔，探春的丫头待书，翠墨、惜春的丫头入画、彩屏，薛姨妈的丫头同喜、同贵，外带着香菱，香菱的丫头臻儿、李氏的丫头素云、碧月，凤姐儿的丫头平儿、丰儿、小红，并[E1]两个丫头也要跟了凤姐儿去的金钏、彩云，奶子抱着大姐儿带着巧姐儿另在一车，还有两个丫头，一共又连上各房的老嬷嬷奶娘并跟出门的家人媳妇子，乌压压的占了一街的车	小儿媳
然后贾母的丫头鸳鸯，鹦鹉，琥珀，珍珠，林黛玉的丫头紫鹃，雪雁，春纤，宝钗的丫头莺儿，文杏，迎春的丫头司棋，绣桔，探春的丫头待书，翠墨、惜春的丫头入画、彩屏，薛姨妈的丫头同喜、同贵，外带着香菱，香菱的丫头臻儿、李氏的丫头素云、碧月，凤姐儿的丫头平儿、丰儿、小红，并[E2]两个丫头也要跟了凤姐儿去的[E1]、彩云，奶子抱着大姐儿带着巧姐儿另在一车，还有两个丫头，一共又连上各房的老嬷嬷奶娘并跟出门的家人媳妇子，乌压压的占了一街的车	大丫环
然后[E2]的丫头[E1]，鹦鹉，琥珀，珍珠，林黛玉的丫头紫鹃，雪雁，春纤，宝钗的丫头莺儿，文杏，迎春的丫头司棋，绣桔，探春的丫头待书，翠墨、惜春的丫头入画、彩屏，薛姨妈的丫头同喜、同贵，外带着香菱，香菱的丫头臻儿、李氏的丫头素云、碧月，凤姐儿的丫头平儿、丰儿、小红，并王夫人两个丫头也要跟了凤姐儿去的金钏、彩云，奶子抱着大姐儿带着巧姐儿另在一车，还有两个丫头，一共又连上各房的老嬷嬷奶娘并跟出门的家人媳妇子，乌压压的占了一街的车	丫头
然后[E2]的丫头鸳鸯，鹦鹉，琥珀，珍珠，[E1]的丫头紫鹃，雪雁，春纤，宝钗的丫头莺儿，文杏，迎春的丫头司棋，绣桔，探春的丫头待书，翠墨、惜春的丫头入画、彩屏，薛姨妈的丫头同喜、同贵，外带着香菱，香菱的丫头臻儿、李氏的丫头素云、碧月，凤姐儿的丫头平儿、丰儿、小红，并王夫人两个丫头也要跟了凤姐儿去的金钏、彩云，奶子抱着大姐儿带着巧姐儿另在一车，还有两个丫头，一共又连上各房的老嬷嬷奶娘并跟出门的家人媳妇子，乌压压的占了一街的车	外孙女
然后贾母的丫头鸳鸯，鹦鹉，琥珀，珍珠，林黛玉的丫头紫鹃，雪雁，春纤，宝钗的丫头莺儿，文杏，迎春的丫头司棋，绣桔，探春的丫头待书，翠墨、惜春的丫头入画、彩屏，[E2]的丫头同喜、同贵，外带着香菱，香菱的丫头臻儿、李氏的丫头素云、碧月，凤姐儿的丫头平儿、丰儿、小红，并[E1]两个丫头也要跟了凤姐儿去的金钏、彩云，奶子抱着大姐儿带着巧姐儿另在一车，还有两个丫头，一共又连上各房的老嬷嬷奶娘并跟出门的家人媳妇子，乌压压的占了一街的车	姐妹
然后[E1]的丫头鸳鸯，鹦鹉，琥珀，珍珠，[E2]的丫头紫鹃，雪雁，春纤，宝钗的丫头莺儿，文杏，迎春的丫头司棋，绣桔，探春的丫头待书，翠墨、惜春的丫头入画、彩屏，薛姨妈的丫头同喜、同贵，外带着香菱，香菱的丫头臻儿、李氏的丫头素云、碧月，凤姐儿的丫头平儿、丰儿、小红，并王夫人两个丫头也要跟了凤姐儿去的金钏、彩云，奶子抱着大姐儿带着巧姐儿另在一车，还有两个丫头，一共又连上各房的老嬷嬷奶娘并跟出门的家人媳妇子，乌压压的占了一街的车	外祖母
然后贾母的丫头鸳鸯，鹦鹉，琥珀，珍珠，[E1]的丫头紫鹃，雪雁，春纤，宝钗的丫头莺儿，文杏，迎春的丫头司棋，绣桔，探春的丫头待书，翠墨、惜春的丫头入画、彩屏，[E2]的丫头同喜、同贵，外带着香菱，香菱的丫头臻儿、李氏的丫头素云、碧月，凤姐儿的丫头平儿、丰儿、小红，并王夫人两个丫头也要跟了凤姐儿去的金钏、彩云，奶子抱着大姐儿带着巧姐儿另在一车，还有两个丫头，一共又连上各房的老嬷嬷奶娘并跟出门的家人媳妇子，乌压压的占了一街的车	无关系
然后贾母的丫头鸳鸯，鹦鹉，琥珀，珍珠，林黛玉的丫头紫鹃，[E1]，春纤，宝钗的丫头莺儿，文杏，迎春的丫头司棋，绣桔，探春的丫头待书，翠墨、惜春的丫头[E2]、彩屏，薛姨妈的丫头同喜、同贵，外带着香菱，香菱的丫头臻儿、李氏的丫头素云、碧月，凤姐儿的丫头平儿、丰儿、小红，并王夫人两个丫头也要跟了凤姐儿去的金钏、彩云，奶子抱着大姐儿带着巧姐儿另在一车，还有两个丫头，一共又连上各房的老嬷嬷奶娘并跟出门的家人媳妇子，乌压压的占了一街的车	无关系
然后贾母的丫头鸳鸯，鹦鹉，琥珀，珍珠，[E1]的丫头[E2]，雪雁，春纤，宝钗的丫头莺儿，文杏，迎春的丫头司棋，绣桔，探春的丫头待书，翠墨、惜春的丫头入画、彩屏，薛姨妈的丫头同喜、同贵，外带着香菱，香菱的丫头臻儿、李氏的丫头素云、碧月，凤姐儿的丫头平儿、丰儿、小红，并王夫人两个丫头也要跟了凤姐儿去的金钏、彩云，奶子抱着大姐儿带着巧姐儿另在一车，还有两个丫头，一共又连上各房的老嬷嬷奶娘并跟出门的家人媳妇子，乌压压的占了一街的车	无关系
然后贾母的丫头鸳鸯，鹦鹉，琥珀，珍珠，林黛玉的丫头紫鹃，[E1]，春纤，宝钗的丫头莺儿，文杏，迎春的丫头司棋，绣桔，探春的丫头待书，翠墨、惜春的丫头入画、彩屏，薛姨妈的丫头同喜、同贵，外带着[E2]，[E2]的丫头臻儿、李氏的丫头素云、碧月，凤姐儿的丫头平儿、丰儿、小红，并王夫人两个丫头也要跟了凤姐儿去的金钏、彩云，奶子抱着大姐儿带着巧姐儿另在一车，还有两个丫头，一共又连上各房的老嬷嬷奶娘并跟出门的家人媳妇子，乌压压的占了一街的车	无关系
然后贾母的丫头鸳鸯，鹦鹉，琥珀，珍珠，林黛玉的丫头紫鹃，[E1]，春纤，宝钗的丫头莺儿，文杏，迎春的丫头司棋，绣桔，探春的丫头待书，翠墨、惜春的丫头入画、彩屏，薛姨妈的丫头同喜、同贵，外带着香菱，香菱的丫头臻儿、李氏的丫头素云、碧月，凤姐儿的丫头平儿、丰儿、小红，并王夫人两个丫头也要跟了凤姐儿去的[E2]、彩云，奶子抱着大姐儿带着巧姐儿另在一车，还有两个丫头，一共又连上各房的老嬷嬷奶娘并跟出门的家人媳妇子，乌压压的占了一街的车	无关系
然后贾母的丫头鸳鸯，鹦鹉，琥珀，珍珠，[E1]的丫头紫鹃，雪雁，春纤，宝钗的丫头莺儿，文杏，迎春的丫头司棋，绣桔，探春的丫头待书，翠墨、惜春的丫头[E2]、彩屏，薛姨妈的丫头同喜、同贵，外带着香菱，香菱的丫头臻儿、李氏的丫头素云、碧月，凤姐儿的丫头平儿、丰儿、小红，并王夫人两个丫头也要跟了凤姐儿去的金钏、彩云，奶子抱着大姐儿带着巧姐儿另在一车，还有两个丫头，一共又连上各房的老嬷嬷奶娘并跟出门的家人媳妇子，乌压压的占了一街的车	无关系
然后贾母的丫头鸳鸯，鹦鹉，琥珀，珍珠，林黛玉的丫头紫鹃，雪雁，春纤，宝钗的丫头莺儿，文杏，迎春的丫头司棋，绣桔，探春的丫头待书，翠墨、惜春的丫头[E1]、彩屏，薛姨妈的丫头同喜、同贵，外带着[E2]，[E2]的丫头臻儿、李氏的丫头素云、碧月，凤姐儿的丫头平儿、丰儿、小红，并王夫人两个丫头也要跟了凤姐儿去的金钏、彩云，奶子抱着大姐儿带着巧姐儿另在一车，还有两个丫头，一共又连上各房的老嬷嬷奶娘并跟出门的家人媳妇子，乌压压的占了一街的车	无关系
然后贾母的丫头鸳鸯，鹦鹉，琥珀，珍珠，林黛玉的丫头紫鹃，雪雁，春纤，宝钗的丫头莺儿，文杏，迎春的丫头司棋，绣桔，探春的丫头待书，翠墨、惜春的丫头[E1]、彩屏，薛姨妈的丫头同喜、同贵，外带着香菱，香菱的丫头臻儿、李氏的丫头素云、碧月，凤姐儿的丫头平儿、丰儿、小红，并王夫人两个丫头也要跟了凤姐儿去的[E2]、彩云，奶子抱着大姐儿带着巧姐儿另在一车，还有两个丫头，一共又连上各房的老嬷嬷奶娘并跟出门的家人媳妇子，乌压压的占了一街的车	无关系
然后贾母的丫头鸳鸯，鹦鹉，琥珀，珍珠，[E1]的丫头紫鹃，雪雁，春纤，宝钗的丫头莺儿，文杏，迎春的丫头司棋，绣桔，探春的丫头待书，翠墨、惜春的丫头入画、彩屏，薛姨妈的丫头同喜、同贵，外带着[E2]，[E2]的丫头臻儿、李氏的丫头素云、碧月，凤姐儿的丫头平儿、丰儿、小红，并王夫人两个丫头也要跟了凤姐儿去的金钏、彩云，奶子抱着大姐儿带着巧姐儿另在一车，还有两个丫头，一共又连上各房的老嬷嬷奶娘并跟出门的家人媳妇子，乌压压的占了一街的车	无关系
然后贾母的丫头[E1]，鹦鹉，琥珀，珍珠，林黛玉的丫头紫鹃，雪雁，春纤，宝钗的丫头莺儿，文杏，迎春的丫头司棋，绣桔，探春的丫头待书，翠墨、惜春的丫头入画、彩屏，薛姨妈的丫头同喜、同贵，外带着香菱，香菱的丫头臻儿、李氏的丫头素云、碧月，凤姐儿的丫头平儿、丰儿、小红，并王夫人两个丫头也要跟了凤姐儿去的金钏、彩云，奶子抱着大姐儿带着[E2]儿另在一车，还有两个丫头，一共又连上各房的老嬷嬷奶娘并跟出门的家人媳妇子，乌压压的占了一街的车	无关系
凤姐儿知道[E1]等在后面，赶不上来搀[E2]，自己下了轿，忙要上来搀	丫头
那小厮们都知道[E1]素日的性子，违拗不得，有个小厮便上来向[E2]脸上啐了一口	父亲
那小厮们都知道[E2]素日的性子，违拗不得，有个小厮便上来向[E1]脸上啐了一口	儿子
[E1]又向[E2]道：“你站着作什么	父亲
[E2]又向[E1]道：“你站着作什么	儿子
刚要说话，只见[E1][E2]的妻子婆媳两个来了，彼此见过，贾母方说：“你们又来做什么，我不过没事来逛逛	父亲
刚要说话，只见[E2][E1]的妻子婆媳两个来了，彼此见过，贾母方说：“你们又来做什么，我不过没事来逛逛	儿子
刚要说话，只见[E1]贾蓉的妻子婆媳两个来了，彼此见过，[E2]方说：“你们又来做什么，我不过没事来逛逛	无关系
刚要说话，只见贾珍[E1]的妻子婆媳两个来了，彼此见过，[E2]方说：“你们又来做什么，我不过没事来逛逛	无关系
”那[E2]因昨日张道士提起宝玉说亲的事来，谁知宝玉一日心中不自在，回家来生气，嗔着张道士与他说了亲，口口声声说从今以后不再见张道士了，别人也并不知为什么原故；二则[E1]昨日回家又中了暑：因此二事，[E2]便执意不去了	外孙女
”那[E1]因昨日张道士提起宝玉说亲的事来，谁知宝玉一日心中不自在，回家来生气，嗔着张道士与他说了亲，口口声声说从今以后不再见张道士了，别人也并不知为什么原故；二则[E2]昨日回家又中了暑：因此二事，[E1]便执意不去了	外祖母
”只顾里头闹，谁知那些老婆子们见[E1]大哭大吐，宝玉又砸玉，不知道要闹到什么田地，倘或连累了他们，便一齐往前头回[E2]王夫人知道，好不干连了他们	外孙女
”只顾里头闹，谁知那些老婆子们见[E2]大哭大吐，宝玉又砸玉，不知道要闹到什么田地，倘或连累了他们，便一齐往前头回[E1]王夫人知道，好不干连了他们	外祖母
”只顾里头闹，谁知那些老婆子们见林黛玉大哭大吐，宝玉又砸玉，不知道要闹到什么田地，倘或连累了他们，便一齐往前头回[E2][E1]知道，好不干连了他们	小儿媳
”只顾里头闹，谁知那些老婆子们见[E1]大哭大吐，宝玉又砸玉，不知道要闹到什么田地，倘或连累了他们，便一齐往前头回贾母[E2]知道，好不干连了他们	无关系
那[E2][E1]见他们忙忙的作一件正经事来告诉，也都不知有了什么大祸，便一齐进园来瞧他兄妹	小儿媳
那[E2]、王夫人进来，见宝玉也无言，[E1]也无话，问起来又没为什么事，便将这祸移到袭人紫鹃两个人身上，说“为什么你们不小心伏侍，这会子闹起来都不管了	外孙女
那[E1]、王夫人进来，见宝玉也无言，[E2]也无话，问起来又没为什么事，便将这祸移到袭人紫鹃两个人身上，说“为什么你们不小心伏侍，这会子闹起来都不管了	外祖母
那[E2]、[E1]进来，见宝玉也无言，林黛玉也无话，问起来又没为什么事，便将这祸移到袭人紫鹃两个人身上，说“为什么你们不小心伏侍，这会子闹起来都不管了	小儿媳
那[E2]、王夫人进来，见宝玉也无言，林黛玉也无话，问起来又没为什么事，便将这祸移到袭人[E1]两个人身上，说“为什么你们不小心伏侍，这会子闹起来都不管了	丫头
那贾母、[E1]进来，见宝玉也无言，林黛玉也无话，问起来又没为什么事，便将这祸移到袭人[E2]两个人身上，说“为什么你们不小心伏侍，这会子闹起来都不管了	无关系
那贾母、[E1]进来，见宝玉也无言，林黛玉也无话，问起来又没为什么事，便将这祸移到[E2]紫鹃两个人身上，说“为什么你们不小心伏侍，这会子闹起来都不管了	无关系
那贾母、王夫人进来，见宝玉也无言，[E1]也无话，问起来又没为什么事，便将这祸移到袭人[E2]两个人身上，说“为什么你们不小心伏侍，这会子闹起来都不管了	无关系
那贾母、王夫人进来，见宝玉也无言，[E1]也无话，问起来又没为什么事，便将这祸移到[E2]紫鹃两个人身上，说“为什么你们不小心伏侍，这会子闹起来都不管了	无关系
那[E1]只一言不发，挨着[E2]坐下	外孙女
那[E2]只一言不发，挨着[E1]坐下	外祖母
[E2]在里间凉榻上睡着，[E1]儿坐在旁边捶腿，也乜斜着眼乱恍	大丫环
[E1]在里间凉榻上睡着，[E2]坐在旁边捶腿，也乜斜着眼乱恍	无关系
”[E1]抿嘴一笑，摆手令他出去，仍合上眼，宝玉见了他，就有些恋恋不舍的，悄悄的探头瞧瞧[E2]合着眼，便自己向身边荷包里带的香雪润津丹掏了出来，便向[E1]儿口里一送	大丫环
”金钏抿嘴一笑，摆手令他出去，仍合上眼，宝玉见了他，就有些恋恋不舍的，悄悄的探头瞧瞧[E1]合着眼，便自己向身边荷包里带的香雪润津丹掏了出来，便向[E2]口里一送	无关系
”只见[E2]翻身起来，照[E1]儿脸上就打了个嘴巴子，指着骂道：“下作小娼妇，好好的爷们，都叫你教坏了	大丫环
”只见[E1]翻身起来，照[E2]脸上就打了个嘴巴子，指着骂道：“下作小娼妇，好好的爷们，都叫你教坏了	无关系
[E2]便叫[E1]：“把你妈叫来，带出你姐姐去	丫头
”[E2]固然是个宽仁慈厚的人，从来不曾打过丫头们一下，今忽见[E1]儿行此无耻之事，此乃平生最恨者，故气忿不过，打了一下，骂了几句	大丫环
”[E1]固然是个宽仁慈厚的人，从来不曾打过丫头们一下，今忽见[E2]行此无耻之事，此乃平生最恨者，故气忿不过，打了一下，骂了几句	无关系
[E2]见宝玉没精打彩，也只当是[E1]儿昨日之事，他没好意思的，越发不理他	大丫环
[E1]见宝玉没精打彩，也只当是[E2]昨日之事，他没好意思的，越发不理他	无关系
凤姐昨日晚间[E2]就告诉了他宝玉[E1]的事，知道[E2]不自在，自己如何敢说笑，也就随着[E2]的气色行事，更觉淡淡的	大丫环
凤姐昨日晚间[E1]就告诉了他宝玉[E2]事，知道[E1]不自在，自己如何敢说笑，也就随着[E1]的气色行事，更觉淡淡的	无关系
至次日午间，王夫人、薛宝钗、[E1]众姊妹正在[E2]房内坐着，就有人回：“史大姑娘来了	外孙女
至次日午间，王夫人、薛宝钗、[E2]众姊妹正在[E1]房内坐着，就有人回：“史大姑娘来了	外祖母
至次日午间，[E1]、薛宝钗、林黛玉众姊妹正在[E2]房内坐着，就有人回：“史大姑娘来了	小儿媳
至次日午间，王夫人、[E1]、林黛玉众姊妹正在[E2]房内坐着，就有人回：“史大姑娘来了	无关系
至次日午间，[E1]、薛宝钗、[E2]众姊妹正在贾母房内坐着，就有人回：“史大姑娘来了	无关系
至次日午间，王夫人、[E1]、[E2]众姊妹正在贾母房内坐着，就有人回：“史大姑娘来了	无关系
原来[E2]知道[E1]在这里，宝玉又赶来，一定说麒麟的原故	朋友
原来宝玉会过雨村回来听见了，便知[E1]儿含羞赌气自尽，心中早又五内摧伤，进来被[E2]数落教训，也无可回说	大丫环
原来宝玉会过雨村回来听见了，便知[E1]含羞赌气自尽，心中早又五内摧伤，进来被[E2]数落教训，也无可回说	无关系
那宝玉听见[E1]吩咐他“不许动”，早知多凶少吉，那里承望[E2]又添了许多的话	父亲
那宝玉听见[E2]吩咐他“不许动”，早知多凶少吉，那里承望[E1]又添了许多的话	儿子
[E1]不敢先回[E2]，只得忙穿衣出来，也不顾有人没人，忙忙赶往书房中来，慌的众门客小厮等避之不及	小儿媳
[E2]一进房来，[E1]更如火上浇油一般，那板子越发下去的又狠又快	丈夫
[E1]一进房来，[E2]更如火上浇油一般，那板子越发下去的又狠又快	妻
[E1]还欲打时，早被[E2]抱住板子	丈夫
[E2]还欲打时，早被[E1]抱住板子	妻
”此时里面的人闻得[E2]出来，那李宫裁[E1]与迎春姊妹早已出来了	内侄女
[E1]哭着[E2]的名字，别人还可，惟有宫裁禁不住也放声哭了	母亲
[E2]哭着[E1]的名字，别人还可，惟有宫裁禁不住也放声哭了	儿子
”[E1]见他母亲来了，又急又痛，连忙迎接出来，只见[E2]扶着丫头，喘吁吁的走来	儿子
[E2]又叫[E1]道：“你也不必哭了	小儿媳
”众人听说连忙进去，果然抬出春凳来，将宝玉抬放凳上，随着[E2][E1]等进去，送至[E2]房中	小儿媳
彼时[E1]见[E2]气未全消，不敢自便，也跟了进去	儿子
话说袭人见[E2][E1]等去后，便走来宝玉身边坐下，含泪问他：“怎么就打到这步田地	小儿媳
话说[E1]见[E2]王夫人等去后，便走来宝玉身边坐下，含泪问他：“怎么就打到这步田地	无关系
”[E2]听了这话，如雷轰电掣的一般，正触了[E1]儿之事，心内越发感爱袭人不尽，忙笑道：“我的儿，你竟有这个心胸，想的这样周全	大丫环
”王夫人听了这话，如雷轰电掣的一般，正触了[E1]之事，心内越发感爱[E2]不尽，忙笑道：“我的儿，你竟有这个心胸，想的这样周全	无关系
定睛看时，只见[E2]搭着凤姐儿的手，后头[E1]王夫人跟着周姨娘并丫鬟媳妇等人都进院去了	大儿媳
定睛看时，只见[E1]搭着凤姐儿的手，后头[E2]王夫人跟着周姨娘并丫鬟媳妇等人都进院去了	婆婆
定睛看时，只见[E2]搭着凤姐儿的手，后头邢夫人[E1]跟着周姨娘并丫鬟媳妇等人都进院去了	小儿媳
定睛看时，只见贾母搭着凤姐儿的手，后头[E1][E2]跟着周姨娘并丫鬟媳妇等人都进院去了	无关系
”一时[E2]换了衣裳，拉着宝钗进去，[E1]方出去了	儿子
”一时[E1]换了衣裳，拉着宝钗进去，[E2]方出去了	母亲
因笑向[E2][E1]道：“你们府上也都想绝了，吃碗汤还有这些样子	小儿媳
”宝玉勾着[E2]原为赞[E1]的，不想反赞起宝钗来，倒也意出望外，便看着宝钗一笑	外孙女
”宝玉勾着[E1]原为赞[E2]的，不想反赞起宝钗来，倒也意出望外，便看着宝钗一笑	外祖母
少顷至园外，[E1]恐[E2]乏了，便欲让至上房内坐	小儿媳
[E2][E1]坐在下面	朋友
[E2]亲捧了茶奉与贾母，李宫裁奉与[E1]	姐妹
[E1]亲捧了茶奉与贾母，李宫裁奉与[E2]	姐妹
[E1]亲捧了茶奉与[E2]，李宫裁奉与薛姨妈	小儿媳
王夫人亲捧了茶奉与[E1]，李宫裁奉与[E2]	无关系
[E2]向[E1]道：“让他们小妯娌伏侍，你在那里坐了，好说话儿	小儿媳
于是凤姐放了四双：上面两双是贾母[E2]，两边是[E1]史湘云的	女儿
于是凤姐放了四双：上面两双是贾母薛姨妈，两边是[E2][E1]的	朋友
于是凤姐放了四双：上面两双是[E2]薛姨妈，两边是薛宝钗[E1]的	孙女
于是凤姐放了四双：上面两双是贾母[E1]，两边是薛宝钗[E2]的	无关系
于是凤姐放了四双：上面两双是[E1]薛姨妈，两边是[E2]史湘云的	无关系
于是凤姐放了四双：上面两双是[E1][E2]，两边是薛宝钗史湘云的	无关系
[E2]回头见[E1]在那边，便令玉钏与宝玉送去	丫头
宝玉见莺儿来了，却倒十分欢喜，忽见了[E1]，便想到他姐姐[E2]身上，又是伤心，又是惭愧，便把莺儿丢下，且和[E1]说话	妹妹
宝玉见莺儿来了，却倒十分欢喜，忽见了[E2]，便想到他姐姐[E1]身上，又是伤心，又是惭愧，便把莺儿丢下，且和[E2]说话	姐姐
话说[E2]自王夫人处回来，见宝玉一日好似一日，心中自是欢喜	丫头
话说[E2]自[E1]处回来，见宝玉一日好似一日，心中自是欢喜	小儿媳
那宝玉本就懒与士大夫诸男人接谈，又最厌峨冠礼服贺吊往还等事，今日得了这句话，越发得了意，不但将亲戚朋友一概杜绝了，而且连家庭中晨昏定省亦发都随他的便了，日日只在园中游卧，不过每日一清早到[E2][E1]处走走就回来了，却每每甘心为诸丫鬟充役，竟也得十分闲消日月	小儿媳
这日午间，[E1]母女两个与林黛玉等正在[E2]房里大家吃东西呢，凤姐儿得便回[E2]道：“自从玉钏儿姐姐死了，太太跟前少着一个人	姐妹
这日午间，[E2]母女两个与林黛玉等正在[E1]房里大家吃东西呢，凤姐儿得便回[E1]道：“自从玉钏儿姐姐死了，太太跟前少着一个人	姐妹
这日午间，薛姨妈母女两个与林黛玉等正在[E2]房里大家吃东西呢，凤姐儿得便回[E2]道：“自从[E1]姐姐死了，太太跟前少着一个人	丫头
这日午间，薛姨妈母女两个与[E1]等正在王夫人房里大家吃东西呢，凤姐儿得便回王夫人道：“自从[E2]姐姐死了，太太跟前少着一个人	无关系
这日午间，薛姨妈母女两个与[E1]等正在[E2]房里大家吃东西呢，凤姐儿得便回[E2]道：“自从玉钏儿姐姐死了，太太跟前少着一个人	无关系
这日午间，[E1]母女两个与林黛玉等正在王夫人房里大家吃东西呢，凤姐儿得便回王夫人道：“自从[E2]姐姐死了，太太跟前少着一个人	无关系
”[E2]听了，又想一想，道：“也罢，这个分例只管关了来，不用补人，就把这一两银子给他妹妹[E1]罢	丫头
不想[E2]因遇见[E1]约他来与袭人道喜，二人来至院中，见静悄悄的，湘云便转身先到厢房里去找袭人	朋友
不想林黛玉因遇见[E1]约他来与[E2]道喜，二人来至院中，见静悄悄的，湘云便转身先到厢房里去找[E2]	无关系
果然是告诉他这话，又叫他与[E1]叩头，且不必去见[E2]，倒把袭人不好意思的	小儿媳
果然是告诉他这话，又叫他与[E1]叩头，且不必去见贾母，倒把[E2]不好意思的	无关系
宝玉听了，以为奇特，少站片时，果见[E2]从外头来了，手里又提着个雀儿笼子，上面扎着个小戏台，并一个雀儿，兴兴头头的往里走着找[E1]	相好
”[E1]起身问是什么，[E2]道：“买了雀儿你顽，省得天天闷闷的无个开心	相好
[E2]一心都在[E1]身上，也不顾送，倒是别的女孩子送了出来	相好
这日甚觉无聊，便往[E2][E1]处来混了一混，仍旧进园来了	小儿媳
略用些酒果，方各自散去，也有回家的，也有往[E2][E1]处去的	小儿媳
”至午，果然贾母带了[E2]凤姐兼请[E1]等进园来	姐妹
”至午，果然贾母带了[E1]凤姐兼请[E2]等进园来	姐妹
”至午，果然[E2]带了[E1]凤姐兼请薛姨妈等进园来	小儿媳
”至午，果然[E1]带了王夫人凤姐兼请[E2]等进园来	无关系
上面一桌，贾母、[E1]、宝钗、黛玉、宝玉；东边一桌，史湘云、[E2]、迎、探、惜；西边靠门一桌，李纨和凤姐的，虚设坐位，二人皆不敢坐，只在贾母[E2]两桌上伺候	姐妹
上面一桌，贾母、[E2]、宝钗、黛玉、宝玉；东边一桌，史湘云、[E1]、迎、探、惜；西边靠门一桌，李纨和凤姐的，虚设坐位，二人皆不敢坐，只在贾母[E1]两桌上伺候	姐妹
上面一桌，[E2]、薛姨妈、宝钗、黛玉、宝玉；东边一桌，[E1]、王夫人、迎、探、惜；西边靠门一桌，李纨和凤姐的，虚设坐位，二人皆不敢坐，只在[E2]王夫人两桌上伺候	孙女
上面一桌，[E2]、薛姨妈、宝钗、黛玉、宝玉；东边一桌，史湘云、[E1]、迎、探、惜；西边靠门一桌，李纨和凤姐的，虚设坐位，二人皆不敢坐，只在[E2][E1]两桌上伺候	小儿媳
上面一桌，贾母、[E1]、宝钗、黛玉、宝玉；东边一桌，[E2]、王夫人、迎、探、惜；西边靠门一桌，李纨和凤姐的，虚设坐位，二人皆不敢坐，只在贾母王夫人两桌上伺候	无关系
上面一桌，贾母、薛姨妈、宝钗、黛玉、宝玉；东边一桌，[E1]、[E2]、迎、探、惜；西边靠门一桌，李纨和凤姐的，虚设坐位，二人皆不敢坐，只在贾母[E2]两桌上伺候	无关系
上面一桌，[E1]、[E2]、宝钗、黛玉、宝玉；东边一桌，史湘云、王夫人、迎、探、惜；西边靠门一桌，李纨和凤姐的，虚设坐位，二人皆不敢坐，只在[E1]王夫人两桌上伺候	无关系
”[E2]和[E1]等听了也笑起来	小儿媳
[E1]因回[E2]说：“这里风大，才又吃了螃蟹，老太太还是回房去歇歇罢了	小儿媳
”说着便都洗了手，大家约往[E2][E1]处问安	小儿媳
”这一夕话，实合了[E2][E1]的心事，连[E1]也都听住了	小儿媳
”宝玉来至上房，只见[E2]正和王夫人众姊妹商议给[E1]还席	孙女
”宝玉来至上房，只见[E2]正和[E1]众姊妹商议给史湘云还席	小儿媳
”宝玉来至上房，只见贾母正和[E1]众姊妹商议给[E2]还席	无关系
”[E1]早打起湘帘，[E2]等进来坐下	丫头
[E1]亲自用小茶盘捧了一盖碗茶来奉与[E2]	外孙女
[E2]亲自用小茶盘捧了一盖碗茶来奉与[E1]	外祖母
说笑一会，[E2]因见窗上纱的颜色旧了，便和[E1]说道：“这个纱新糊上好看，过了后来就不翠了	小儿媳
[E1]带着迎春姊妹三个人一桌，刘姥姥傍着[E2]一桌	小儿媳
[E1]带着迎春姊妹三个人一桌，[E2]傍着贾母一桌	无关系
[E1]撑不住，一口饭都喷了出来；[E2]笑岔了气，伏着桌子嗳哟；宝玉早滚到贾母怀里，贾母笑的搂着宝玉叫“心肝”；王夫人笑的用手指着凤姐儿，只说不出话来；薛姨妈也撑不住，口里茶喷了探春一裙子；探春手里的饭碗都合在迎春身上；惜春离了坐位，拉着他奶母叫揉一揉肠子	朋友
史湘云撑不住，一口饭都喷了出来；林黛玉笑岔了气，伏着桌子嗳哟；宝玉早滚到贾母怀里，贾母笑的搂着宝玉叫“心肝”；[E2]笑的用手指着凤姐儿，只说不出话来；[E1]也撑不住，口里茶喷了探春一裙子；探春手里的饭碗都合在迎春身上；惜春离了坐位，拉着他奶母叫揉一揉肠子	姐妹
史湘云撑不住，一口饭都喷了出来；林黛玉笑岔了气，伏着桌子嗳哟；宝玉早滚到[E2]怀里，[E2]笑的搂着宝玉叫“心肝”；[E1]笑的用手指着凤姐儿，只说不出话来；薛姨妈也撑不住，口里茶喷了探春一裙子；探春手里的饭碗都合在迎春身上；惜春离了坐位，拉着他奶母叫揉一揉肠子	小儿媳
史湘云撑不住，一口饭都喷了出来；[E1]笑岔了气，伏着桌子嗳哟；宝玉早滚到[E2]怀里，[E2]笑的搂着宝玉叫“心肝”；王夫人笑的用手指着凤姐儿，只说不出话来；薛姨妈也撑不住，口里茶喷了探春一裙子；探春手里的饭碗都合在迎春身上；惜春离了坐位，拉着他奶母叫揉一揉肠子	外孙女
史湘云撑不住，一口饭都喷了出来；林黛玉笑岔了气，伏着桌子嗳哟；宝玉早滚到贾母怀里，贾母笑的搂着宝玉叫“心肝”；[E1]笑的用手指着凤姐儿，只说不出话来；[E2]也撑不住，口里茶喷了探春一裙子；探春手里的饭碗都合在迎春身上；惜春离了坐位，拉着他奶母叫揉一揉肠子	姐妹
[E1]撑不住，一口饭都喷了出来；林黛玉笑岔了气，伏着桌子嗳哟；宝玉早滚到[E2]怀里，[E2]笑的搂着宝玉叫“心肝”；王夫人笑的用手指着凤姐儿，只说不出话来；薛姨妈也撑不住，口里茶喷了探春一裙子；探春手里的饭碗都合在迎春身上；惜春离了坐位，拉着他奶母叫揉一揉肠子	孙女
史湘云撑不住，一口饭都喷了出来；[E2]笑岔了气，伏着桌子嗳哟；宝玉早滚到[E1]怀里，[E1]笑的搂着宝玉叫“心肝”；王夫人笑的用手指着凤姐儿，只说不出话来；薛姨妈也撑不住，口里茶喷了探春一裙子；探春手里的饭碗都合在迎春身上；惜春离了坐位，拉着他奶母叫揉一揉肠子	外祖母
史湘云撑不住，一口饭都喷了出来；[E1]笑岔了气，伏着桌子嗳哟；宝玉早滚到贾母怀里，贾母笑的搂着宝玉叫“心肝”；王夫人笑的用手指着凤姐儿，只说不出话来；[E2]也撑不住，口里茶喷了探春一裙子；探春手里的饭碗都合在迎春身上；惜春离了坐位，拉着他奶母叫揉一揉肠子	无关系
[E1]撑不住，一口饭都喷了出来；林黛玉笑岔了气，伏着桌子嗳哟；宝玉早滚到贾母怀里，贾母笑的搂着宝玉叫“心肝”；[E2]笑的用手指着凤姐儿，只说不出话来；薛姨妈也撑不住，口里茶喷了探春一裙子；探春手里的饭碗都合在迎春身上；惜春离了坐位，拉着他奶母叫揉一揉肠子	无关系
[E1]撑不住，一口饭都喷了出来；林黛玉笑岔了气，伏着桌子嗳哟；宝玉早滚到贾母怀里，贾母笑的搂着宝玉叫“心肝”；王夫人笑的用手指着凤姐儿，只说不出话来；[E2]也撑不住，口里茶喷了探春一裙子；探春手里的饭碗都合在迎春身上；惜春离了坐位，拉着他奶母叫揉一揉肠子	无关系
史湘云撑不住，一口饭都喷了出来；[E1]笑岔了气，伏着桌子嗳哟；宝玉早滚到贾母怀里，贾母笑的搂着宝玉叫“心肝”；[E2]笑的用手指着凤姐儿，只说不出话来；薛姨妈也撑不住，口里茶喷了探春一裙子；探春手里的饭碗都合在迎春身上；惜春离了坐位，拉着他奶母叫揉一揉肠子	无关系
史湘云撑不住，一口饭都喷了出来；林黛玉笑岔了气，伏着桌子嗳哟；宝玉早滚到[E1]怀里，[E1]笑的搂着宝玉叫“心肝”；王夫人笑的用手指着凤姐儿，只说不出话来；[E2]也撑不住，口里茶喷了探春一裙子；探春手里的饭碗都合在迎春身上；惜春离了坐位，拉着他奶母叫揉一揉肠子	无关系
那姑苏选来的几个驾娘早把两只棠木舫撑来，众人扶了贾母，[E2]、薛姨妈、刘姥姥、鸳鸯、[E1]上了这一只，落后李纨也跟上去	丫头
那姑苏选来的几个驾娘早把两只棠木舫撑来，众人扶了贾母，[E2]、[E1]、刘姥姥、鸳鸯、玉钏儿上了这一只，落后李纨也跟上去	姐妹
那姑苏选来的几个驾娘早把两只棠木舫撑来，众人扶了[E2]，[E1]、薛姨妈、刘姥姥、鸳鸯、玉钏儿上了这一只，落后李纨也跟上去	小儿媳
那姑苏选来的几个驾娘早把两只棠木舫撑来，众人扶了[E2]，王夫人、薛姨妈、刘姥姥、[E1]、玉钏儿上了这一只，落后李纨也跟上去	丫头
那姑苏选来的几个驾娘早把两只棠木舫撑来，众人扶了贾母，[E1]、[E2]、刘姥姥、鸳鸯、玉钏儿上了这一只，落后李纨也跟上去	姐妹
那姑苏选来的几个驾娘早把两只棠木舫撑来，众人扶了[E1]，王夫人、薛姨妈、刘姥姥、鸳鸯、[E2]上了这一只，落后李纨也跟上去	无关系
那姑苏选来的几个驾娘早把两只棠木舫撑来，众人扶了贾母，[E1]、薛姨妈、[E2]、鸳鸯、玉钏儿上了这一只，落后李纨也跟上去	无关系
那姑苏选来的几个驾娘早把两只棠木舫撑来，众人扶了贾母，王夫人、[E1]、[E2]、鸳鸯、玉钏儿上了这一只，落后李纨也跟上去	无关系
那姑苏选来的几个驾娘早把两只棠木舫撑来，众人扶了贾母，[E1]、薛姨妈、刘姥姥、[E2]、玉钏儿上了这一只，落后李纨也跟上去	无关系
那姑苏选来的几个驾娘早把两只棠木舫撑来，众人扶了[E1]，王夫人、薛姨妈、[E2]、鸳鸯、玉钏儿上了这一只，落后李纨也跟上去	无关系
上面二榻四几，是贾母[E1]；下面一椅两几，是[E2]的，余者都是一椅一几	姐妹
上面二榻四几，是贾母[E2]；下面一椅两几，是[E1]的，余者都是一椅一几	姐妹
上面二榻四几，是[E2]薛姨妈；下面一椅两几，是[E1]的，余者都是一椅一几	小儿媳
上面二榻四几，是[E1][E2]；下面一椅两几，是王夫人的，余者都是一椅一几	无关系
”众人都知[E2]所行之令必得[E1]提着，故听了这话，都说“很是”	丫头
”贾母，[E1]，[E2]知道他上了年纪的人，禁不起，忙笑道：“说是说，笑是笑，不可多吃了，只吃这头一杯罢	姐妹
”贾母，[E2]，[E1]知道他上了年纪的人，禁不起，忙笑道：“说是说，笑是笑，不可多吃了，只吃这头一杯罢	姐妹
”[E2]，薛姨妈，[E1]知道他上了年纪的人，禁不起，忙笑道：“说是说，笑是笑，不可多吃了，只吃这头一杯罢	小儿媳
”[E1]，[E2]，王夫人知道他上了年纪的人，禁不起，忙笑道：“说是说，笑是笑，不可多吃了，只吃这头一杯罢	无关系
一时暖酒来了，宝玉仍归旧坐，[E2]提了暖壶下席来，众人皆都出了席，[E1]也立起来，贾母忙命李、凤二人接过壶来：“让你姨妈坐了，大家才便	姐妹
一时暖酒来了，宝玉仍归旧坐，[E1]提了暖壶下席来，众人皆都出了席，[E2]也立起来，贾母忙命李、凤二人接过壶来：“让你姨妈坐了，大家才便	姐妹
一时暖酒来了，宝玉仍归旧坐，[E1]提了暖壶下席来，众人皆都出了席，薛姨妈也立起来，[E2]忙命李、凤二人接过壶来：“让你姨妈坐了，大家才便	小儿媳
一时暖酒来了，宝玉仍归旧坐，王夫人提了暖壶下席来，众人皆都出了席，[E1]也立起来，[E2]忙命李、凤二人接过壶来：“让你姨妈坐了，大家才便	无关系
且说贾母因觉身上乏倦，便命[E2]和迎春姊妹陪了[E1]去吃酒，自己便往稻香村来歇息	姐妹
且说贾母因觉身上乏倦，便命[E1]和迎春姊妹陪了[E2]去吃酒，自己便往稻香村来歇息	姐妹
且说[E2]因觉身上乏倦，便命[E1]和迎春姊妹陪了薛姨妈去吃酒，自己便往稻香村来歇息	小儿媳
且说[E1]因觉身上乏倦，便命王夫人和迎春姊妹陪了[E2]去吃酒，自己便往稻香村来歇息	无关系
[E1]打发文官等出去，将攒盒散与众丫鬟们吃去，自己便也乘空歇着，随便歪在方才[E2]坐的榻上，命一个小丫头放下帘子来，又命他捶着腿，吩咐他：“老太太那里有信，你就叫我	小儿媳
[E1]打发[E2]等出去，将攒盒散与众丫鬟们吃去，自己便也乘空歇着，随便歪在方才贾母坐的榻上，命一个小丫头放下帘子来，又命他捶着腿，吩咐他：“老太太那里有信，你就叫我	无关系
一时只见[E1]、贾琏、[E2]三个人将王太医领来	父亲
一时只见[E2]、贾琏、[E1]三个人将王太医领来	儿子
一时只见贾珍、[E1]、[E2]三个人将王太医领来	无关系
一时只见[E1]、[E2]、贾蓉三个人将王太医领来	无关系
话说王夫人因见[E2]那日在大观园不过着了些风寒，不是什么大病，请医生吃了两剂药也就好了，便放了心，因命凤姐来吩咐他预备给[E1]带送东西	儿子
话说[E2]因见贾母那日在大观园不过着了些风寒，不是什么大病，请医生吃了两剂药也就好了，便放了心，因命凤姐来吩咐他预备给[E1]带送东西	丈夫
话说[E1]因见[E2]那日在大观园不过着了些风寒，不是什么大病，请医生吃了两剂药也就好了，便放了心，因命凤姐来吩咐他预备给贾政带送东西	小儿媳
话说[E1]因见贾母那日在大观园不过着了些风寒，不是什么大病，请医生吃了两剂药也就好了，便放了心，因命凤姐来吩咐他预备给[E2]带送东西	妻
正商议着，只见[E2]打发人来请，[E1]忙引着凤姐儿过来	小儿媳
这里[E2]又向[E1]笑道：“我打发人请你来，不为别的	小儿媳
”[E2]听说，益发高兴起来，忙遣人去请薛姨妈[E1]等，又叫请姑娘们并宝玉，那府里珍儿媳妇并赖大家的等有头脸管事的媳妇也都叫了来	大儿媳
”[E1]听说，益发高兴起来，忙遣人去请薛姨妈[E2]等，又叫请姑娘们并宝玉，那府里珍儿媳妇并赖大家的等有头脸管事的媳妇也都叫了来	婆婆
”贾母听说，益发高兴起来，忙遣人去请薛姨妈[E1]等，又叫请姑娘们并宝玉，那府里珍儿媳妇并[E2]家的等有头脸管事的媳妇也都叫了来	无关系
”[E1]听说，益发高兴起来，忙遣人去请[E2]邢夫人等，又叫请姑娘们并宝玉，那府里珍儿媳妇并赖大家的等有头脸管事的媳妇也都叫了来	无关系
只[E1]和贾母对坐，邢夫人[E2]只坐在房门前两张椅子上，宝钗姊妹等五六个人坐在炕上，宝玉坐在贾母怀前，地下满满的站了一地	姐妹
只薛姨妈和[E2]对坐，[E1]王夫人只坐在房门前两张椅子上，宝钗姊妹等五六个人坐在炕上，宝玉坐在[E2]怀前，地下满满的站了一地	大儿媳
只薛姨妈和[E2]对坐，邢夫人[E1]只坐在房门前两张椅子上，宝钗姊妹等五六个人坐在炕上，宝玉坐在[E2]怀前，地下满满的站了一地	小儿媳
只[E2]和贾母对坐，邢夫人[E1]只坐在房门前两张椅子上，宝钗姊妹等五六个人坐在炕上，宝玉坐在贾母怀前，地下满满的站了一地	姐妹
只薛姨妈和[E1]对坐，[E2]王夫人只坐在房门前两张椅子上，宝钗姊妹等五六个人坐在炕上，宝玉坐在[E1]怀前，地下满满的站了一地	婆婆
只[E1]和[E2]对坐，邢夫人王夫人只坐在房门前两张椅子上，宝钗姊妹等五六个人坐在炕上，宝玉坐在[E2]怀前，地下满满的站了一地	无关系
只薛姨妈和贾母对坐，[E1][E2]只坐在房门前两张椅子上，宝钗姊妹等五六个人坐在炕上，宝玉坐在贾母怀前，地下满满的站了一地	无关系
只[E1]和贾母对坐，[E2]王夫人只坐在房门前两张椅子上，宝钗姊妹等五六个人坐在炕上，宝玉坐在贾母怀前，地下满满的站了一地	无关系
先请了安，大概说了两句话，便走到[E1]房中和[E1]商议，只听[E1]的主意行事，何以讨[E2]的喜欢	丫头
因[E2]进了佛堂，把[E1]一分也还了他	大丫头
宝玉忙进厅里，见了[E2][E1]等，众人真如得了凤凰一般	小儿媳
[E2][E1]都说他不知道好歹，“怎么也不说声就私自跑了，这还了得	小儿媳
”[E2]、[E1]、王夫人等忙问怎么了	大儿媳
”[E1]、[E2]、王夫人等忙问怎么了	婆婆
”[E2]、邢夫人、[E1]等忙问怎么了	小儿媳
”贾母、[E1]、[E2]等忙问怎么了	无关系
[E1]记挂着昨日贾琏醉了，忙一早过来，叫了贾琏过[E2]这边来	大儿媳
[E2]记挂着昨日贾琏醉了，忙一早过来，叫了贾琏过[E1]这边来	婆婆
邢夫人记挂着昨日[E1]醉了，忙一早过来，叫了[E1]过[E2]这边来	无关系
[E1]记挂着昨日[E2]醉了，忙一早过来，叫了[E2]过贾母这边来	无关系
周瑞家的磕头起来，又要与[E1]磕头，[E2]家的拉着方罢	母亲
[E1]磕头起来，又要与赖嬷嬷磕头，[E2]家的拉着方罢	无关系
日间至[E2]处[E1]处省候两次，不免又承色陪坐闲话半时，园中姊妹处也要度时闲话一回，故日间不大得闲，每夜灯下女工必至三更方寝	小儿媳
凤姐儿知道[E1]禀性愚亻强，只知承顺[E2]以自保，次则婪取财货为自得，家下一应大小事务，俱由[E2]摆布	妻
凤姐儿知道[E2]禀性愚亻强，只知承顺[E1]以自保，次则婪取财货为自得，家下一应大小事务，俱由[E1]摆布	丈夫
邢夫人听了有理，便自往[E2]处，和[E2]说了一回闲话，便出来假托往王夫人房里去，从后门出去，打[E1]的卧房前过	丫头
[E1]听了有理，便自往[E2]处，和[E2]说了一回闲话，便出来假托往王夫人房里去，从后门出去，打鸳鸯的卧房前过	大儿媳
[E2]听了有理，便自往[E1]处，和[E1]说了一回闲话，便出来假托往王夫人房里去，从后门出去，打鸳鸯的卧房前过	婆婆
邢夫人听了有理，便自往[E2]处，和[E2]说了一回闲话，便出来假托往[E1]房里去，从后门出去，打鸳鸯的卧房前过	小儿媳
[E1]听了有理，便自往贾母处，和贾母说了一回闲话，便出来假托往王夫人房里去，从后门出去，打[E2]的卧房前过	无关系
[E1]听了有理，便自往贾母处，和贾母说了一回闲话，便出来假托往[E2]房里去，从后门出去，打鸳鸯的卧房前过	无关系
邢夫人听了有理，便自往贾母处，和贾母说了一回闲话，便出来假托往[E1]房里去，从后门出去，打[E2]的卧房前过	无关系
[E1]无计，吃了饭回家，晚间告诉了[E2]	妻
[E2]无计，吃了饭回家，晚间告诉了[E1]	丈夫
[E2]想了一想，即刻叫[E1]来说：“南京的房子还有人看着，不止一家，即刻叫上金彩来	儿子
[E1]想了一想，即刻叫[E2]来说：“南京的房子还有人看着，不止一家，即刻叫上金彩来	父亲
[E1]暂且不敢打听，隔了一会，又打听[E2]睡了，方才过来	儿子
[E2]暂且不敢打听，隔了一会，又打听[E1]睡了，方才过来	父亲
[E1]一夜没睡，至次日，他哥哥回[E2]接他家去逛逛，[E2]允了，命他出去	丫头
[E1]意欲不去，又怕[E2]疑心，只得勉强出来	丫头
[E2]怒起来，因说道：“我这话告诉你，叫你女人向他说去，就说我的话：‘自古嫦娥爱少年.. ’，他必定嫌我老了，大约他恋着少爷们，多半是看上了宝玉，只怕也有[E1]	儿子
[E1]怒起来，因说道：“我这话告诉你，叫你女人向他说去，就说我的话：‘自古嫦娥爱少年.. ’，他必定嫌我老了，大约他恋着少爷们，多半是看上了宝玉，只怕也有[E2]	父亲
可巧[E2]、[E1]、李纨、凤姐儿、宝钗等姊妹并外头的几个执事有头脸的媳妇，都在贾母跟前凑趣儿呢	姐妹
可巧[E1]、[E2]、李纨、凤姐儿、宝钗等姊妹并外头的几个执事有头脸的媳妇，都在贾母跟前凑趣儿呢	姐妹
可巧[E1]、薛姨妈、李纨、凤姐儿、宝钗等姊妹并外头的几个执事有头脸的媳妇，都在[E2]跟前凑趣儿呢	小儿媳
可巧王夫人、[E1]、李纨、凤姐儿、宝钗等姊妹并外头的几个执事有头脸的媳妇，都在[E2]跟前凑趣儿呢	无关系
[E1]喜之不尽，拉了他嫂子，到[E2]跟前跪下，一行哭，一行说，把邢夫人怎么来说，园子里他嫂子又如何说，今儿他哥哥又如何说，“因为不依，方才大老爷越性说我恋着宝玉，不然要等着往外聘，我到天上，这一辈子也跳不出他的手心去，终久要报仇	丫头
鸳鸯喜之不尽，拉了他嫂子，到[E2]跟前跪下，一行哭，一行说，把[E1]怎么来说，园子里他嫂子又如何说，今儿他哥哥又如何说，“因为不依，方才大老爷越性说我恋着宝玉，不然要等着往外聘，我到天上，这一辈子也跳不出他的手心去，终久要报仇	大儿媳
鸳鸯喜之不尽，拉了他嫂子，到[E1]跟前跪下，一行哭，一行说，把[E2]怎么来说，园子里他嫂子又如何说，今儿他哥哥又如何说，“因为不依，方才大老爷越性说我恋着宝玉，不然要等着往外聘，我到天上，这一辈子也跳不出他的手心去，终久要报仇	婆婆
[E1]喜之不尽，拉了他嫂子，到贾母跟前跪下，一行哭，一行说，把[E2]怎么来说，园子里他嫂子又如何说，今儿他哥哥又如何说，“因为不依，方才大老爷越性说我恋着宝玉，不然要等着往外聘，我到天上，这一辈子也跳不出他的手心去，终久要报仇	无关系
[E1]见连[E2]怪上，反不好劝的了	姐妹
[E2]见连[E1]怪上，反不好劝的了	姐妹
探春有心的人，想[E2]虽有委曲，如何敢辩；[E1]也是亲姊妹，自然也不好辩的；宝钗也不便为姨母辩；李纨、凤姐、宝玉一概不敢辩；这正用着女孩儿之时，迎春老实，惜春小，因此窗外听了一听，便走进来陪笑向贾母道：“这事与太太什么相干	姐妹
探春有心的人，想[E1]虽有委曲，如何敢辩；[E2]也是亲姊妹，自然也不好辩的；宝钗也不便为姨母辩；李纨、凤姐、宝玉一概不敢辩；这正用着女孩儿之时，迎春老实，惜春小，因此窗外听了一听，便走进来陪笑向贾母道：“这事与太太什么相干	姐妹
探春有心的人，想[E1]虽有委曲，如何敢辩；薛姨妈也是亲姊妹，自然也不好辩的；宝钗也不便为姨母辩；李纨、凤姐、宝玉一概不敢辩；这正用着女孩儿之时，迎春老实，惜春小，因此窗外听了一听，便走进来陪笑向[E2]道：“这事与太太什么相干	小儿媳
探春有心的人，想王夫人虽有委曲，如何敢辩；[E1]也是亲姊妹，自然也不好辩的；宝钗也不便为姨母辩；李纨、凤姐、宝玉一概不敢辩；这正用着女孩儿之时，迎春老实，惜春小，因此窗外听了一听，便走进来陪笑向[E2]道：“这事与太太什么相干	无关系
邢夫人犹不知[E2]已知[E1]之事，正还要来打听信息，进了院门，早有几个婆子悄悄的回了他，他方知道	丫头
[E1]犹不知[E2]已知鸳鸯之事，正还要来打听信息，进了院门，早有几个婆子悄悄的回了他，他方知道	大儿媳
[E2]犹不知[E1]已知鸳鸯之事，正还要来打听信息，进了院门，早有几个婆子悄悄的回了他，他方知道	婆婆
[E1]犹不知贾母已知[E2]之事，正还要来打听信息，进了院门，早有几个婆子悄悄的回了他，他方知道	无关系
待要回去，里面已知，又见[E1]接了出来，少不得进来，先与[E2]请安，[E2]一声儿不言语，自己也觉得愧悔	小儿媳
[E1][E2]等恐碍着邢夫人的脸面，也都渐渐的退了	姐妹
[E2][E1]等恐碍着邢夫人的脸面，也都渐渐的退了	姐妹
[E1]王夫人等恐碍着[E2]的脸面，也都渐渐的退了	无关系
薛姨妈[E1]等恐碍着[E2]的脸面，也都渐渐的退了	无关系
”[E2]道：“叫[E1]来，叫他在这下手里坐着	丫头
一时[E1]来了，便坐在[E2]下手，[E1]之下便是凤姐儿	丫头
斗了一回，[E1]见[E2]的牌已十严，只等一张二饼，便递了暗号与凤姐儿	丫头
”[E2]规矩是[E1]代洗牌，因和薛姨妈说笑，不见[E1]动手，[E2]道：“你怎么恼了，连牌也不替我洗	丫头
”贾母规矩是[E1]代洗牌，因和[E2]说笑，不见[E1]动手，贾母道：“你怎么恼了，连牌也不替我洗	无关系
”[E2]笑的手里的牌撒了一桌子，推着[E1]，叫：“快撕他的嘴	丫头
[E1]不便就走，只得倒了一碗茶来，放在[E2]跟前	大儿媳
[E2]不便就走，只得倒了一碗茶来，放在[E1]跟前	婆婆
[E2]将方才的话只略说了几句，[E1]无法，又含愧，自此便告病，且不敢见贾母，只打发[E2]及贾琏每日过去请安	丈夫
[E1]将方才的话只略说了几句，贾赦无法，又含愧，自此便告病，且不敢见[E2]，只打发[E1]及贾琏每日过去请安	大儿媳
邢夫人将方才的话只略说了几句，[E2]无法，又含愧，自此便告病，且不敢见贾母，只打发邢夫人及[E1]每日过去请安	儿子
邢夫人将方才的话只略说了几句，[E2]无法，又含愧，自此便告病，且不敢见[E1]，只打发邢夫人及贾琏每日过去请安	母亲
[E2]将方才的话只略说了几句，贾赦无法，又含愧，自此便告病，且不敢见[E1]，只打发[E2]及贾琏每日过去请安	婆婆
邢夫人将方才的话只略说了几句，[E1]无法，又含愧，自此便告病，且不敢见贾母，只打发邢夫人及[E2]每日过去请安	父亲
邢夫人将方才的话只略说了几句，[E1]无法，又含愧，自此便告病，且不敢见[E2]，只打发邢夫人及贾琏每日过去请安	儿子
[E1]将方才的话只略说了几句，[E2]无法，又含愧，自此便告病，且不敢见贾母，只打发[E1]及贾琏每日过去请安	妻
邢夫人将方才的话只略说了几句，贾赦无法，又含愧，自此便告病，且不敢见[E1]，只打发邢夫人及[E2]每日过去请安	无关系
[E1]将方才的话只略说了几句，贾赦无法，又含愧，自此便告病，且不敢见贾母，只打发[E1]及[E2]每日过去请安	无关系
贾母高兴，便带了[E2][E1]及宝玉姊妹等，到赖大花园中坐了半日	姐妹
贾母高兴，便带了[E1][E2]及宝玉姊妹等，到赖大花园中坐了半日	姐妹
[E2]高兴，便带了[E1]薛姨妈及宝玉姊妹等，到赖大花园中坐了半日	小儿媳
贾母高兴，便带了[E1]薛姨妈及宝玉姊妹等，到[E2]花园中坐了半日	无关系
[E1]高兴，便带了王夫人[E2]及宝玉姊妹等，到赖大花园中坐了半日	无关系
贾母高兴，便带了王夫人[E1]及宝玉姊妹等，到[E2]花园中坐了半日	无关系
外面厅上，薛蟠、[E1]、贾琏、[E2]并几个近族的，很远的也没来，贾赦也没来	父亲
外面厅上，薛蟠、[E2]、贾琏、[E1]并几个近族的，很远的也没来，贾赦也没来	儿子
外面厅上，薛蟠、贾珍、[E1]、贾蓉并几个近族的，很远的也没来，[E2]也没来	儿子
外面厅上，薛蟠、贾珍、[E2]、贾蓉并几个近族的，很远的也没来，[E1]也没来	父亲
外面厅上，[E1]、贾珍、贾琏、[E2]并几个近族的，很远的也没来，贾赦也没来	无关系
外面厅上，薛蟠、[E1]、贾琏、贾蓉并几个近族的，很远的也没来，[E2]也没来	无关系
外面厅上，[E1]、贾珍、[E2]、贾蓉并几个近族的，很远的也没来，贾赦也没来	无关系
外面厅上，[E1]、[E2]、贾琏、贾蓉并几个近族的，很远的也没来，贾赦也没来	无关系
因其中有[E1]，[E2]自上次会过一次，已念念不忘	好兄弟
后来还是[E1]不放心，命[E2]带着小厮们寻踪问迹的直找出北门，下桥二里多路，忽见苇坑边薛蟠的马拴在那里	父亲
后来还是[E2]不放心，命[E1]带着小厮们寻踪问迹的直找出北门，下桥二里多路，忽见苇坑边薛蟠的马拴在那里	儿子
后来还是[E1]不放心，命贾蓉带着小厮们寻踪问迹的直找出北门，下桥二里多路，忽见苇坑边[E2]的马拴在那里	无关系
后来还是贾珍不放心，命[E1]带着小厮们寻踪问迹的直找出北门，下桥二里多路，忽见苇坑边[E2]的马拴在那里	无关系
[E2]仍往赖家回复[E1]，并说方才形景	父亲
[E1]仍往赖家回复[E2]，并说方才形景	儿子
[E2]又是心疼，又是发恨，骂一回[E1]，又骂一回柳湘莲，意欲告诉王夫人，遣人寻拿柳湘莲	儿子
薛姨妈又是心疼，又是发恨，骂一回[E2]，又骂一回[E1]，意欲告诉王夫人，遣人寻拿[E1]	好兄弟
[E1]又是心疼，又是发恨，骂一回薛蟠，又骂一回柳湘莲，意欲告诉[E2]，遣人寻拿柳湘莲	姐妹
[E1]又是心疼，又是发恨，骂一回[E2]，又骂一回柳湘莲，意欲告诉王夫人，遣人寻拿柳湘莲	母亲
[E2]又是心疼，又是发恨，骂一回薛蟠，又骂一回柳湘莲，意欲告诉[E1]，遣人寻拿柳湘莲	姐妹
薛姨妈又是心疼，又是发恨，骂一回薛蟠，又骂一回[E1]，意欲告诉[E2]，遣人寻拿[E1]	无关系
[E1]又是心疼，又是发恨，骂一回薛蟠，又骂一回[E2]，意欲告诉王夫人，遣人寻拿[E2]	无关系
薛姨妈又是心疼，又是发恨，骂一回[E1]，又骂一回柳湘莲，意欲告诉[E2]，遣人寻拿柳湘莲	无关系
”[E2]睡在炕上痛骂[E1]，又命小厮们去拆他的房子，打死他，和他打官司	好兄弟
至次日，[E2]命人请了张德辉来，在书房中命[E1]款待酒饭，自己在后廊下，隔着窗子，向里千言万语嘱托张德辉照管[E1]	儿子
至次日，[E1]命人请了张德辉来，在书房中命[E2]款待酒饭，自己在后廊下，隔着窗子，向里千言万语嘱托张德辉照管[E2]	母亲
”[E1]喜之不尽，将此话告诉了[E2]	儿子
”[E2]喜之不尽，将此话告诉了[E1]	母亲
[E2]便和宝钗香菱并两个老年的嬷嬷连日打点行装，派下[E1]之乳父老苍头一名，当年谙事旧仆二名，外有[E1]随身常使小厮二人，主仆一共六人，雇了三辆大车，单拉行李使物，又雇了四个长行骡子	儿子
[E1]便和宝钗香菱并两个老年的嬷嬷连日打点行装，派下[E2]之乳父老苍头一名，当年谙事旧仆二名，外有[E2]随身常使小厮二人，主仆一共六人，雇了三辆大车，单拉行李使物，又雇了四个长行骡子	母亲
薛姨妈便和宝钗[E1]并两个老年的嬷嬷连日打点行装，派下[E2]之乳父老苍头一名，当年谙事旧仆二名，外有[E2]随身常使小厮二人，主仆一共六人，雇了三辆大车，单拉行李使物，又雇了四个长行骡子	妾
[E1]便和宝钗[E2]并两个老年的嬷嬷连日打点行装，派下薛蟠之乳父老苍头一名，当年谙事旧仆二名，外有薛蟠随身常使小厮二人，主仆一共六人，雇了三辆大车，单拉行李使物，又雇了四个长行骡子	无关系
至十四日一早，[E2]宝钗等直同[E1]出了仪门，母女两个四只泪眼看他去了，方回来	儿子
至十四日一早，[E1]宝钗等直同[E2]出了仪门，母女两个四只泪眼看他去了，方回来	母亲
[E2]上京带来的家人不过四五房，并两三个老嬷嬷小丫头，今跟了[E1]一去，外面只剩了一两个男子	儿子
[E1]上京带来的家人不过四五房，并两三个老嬷嬷小丫头，今跟了[E2]一去，外面只剩了一两个男子	母亲
后有薛蟠之从弟[E2]，因当年父亲在京时已将胞妹[E1]许配都中梅翰林之子为婚，正欲进京发嫁，闻得王仁进京，他也带了妹子随后赶来	胞妹
后有[E1]之从弟薛蝌，因当年父亲在京时已将胞妹[E2]许配都中梅翰林之子为婚，正欲进京发嫁，闻得王仁进京，他也带了妹子随后赶来	无关系
于是大家见礼叙过，[E2][E1]都欢喜非常	小儿媳
果然[E1]已认了宝琴作干女儿，[E2]欢喜非常，连园中也不命住，晚上跟着[E2]一处安寝	小儿媳
[E2]便和[E1]说：“你侄女儿也不必家去了，园里赘天，逛逛再去	大儿媳
[E1]便和[E2]说：“你侄女儿也不必家去了，园里赘天，逛逛再去	婆婆
凤姐儿筹算得园中姊妹多，性情不一，且又不便另设一处，莫若送到迎春一处去，倘日后[E1]有些不遂意的事，纵然[E2]知道了，与自己无干	侄女
[E2][E1]因素喜李纨贤惠，且年轻守节，令人敬伏，今见他寡婶来了，便不肯令他外头去住	小儿媳
一时宝钗姊妹往薛姨妈房内去后，湘云往[E2]处来，[E1]回房歇着	外孙女
一时宝钗姊妹往薛姨妈房内去后，湘云往[E1]处来，[E2]回房歇着	外祖母
一时宝钗姊妹往[E1]房内去后，湘云往[E2]处来，林黛玉回房歇着	无关系
一时宝钗姊妹往[E1]房内去后，湘云往贾母处来，[E2]回房歇着	无关系
一时[E1]来了，穿着[E2]与他的一件貂鼠脑袋面子大毛黑灰鼠里子里外发烧大褂子，头上带着一顶挖云鹅黄片金里大红猩猩毡昭君套，又围着大貂鼠风领	孙女
”说着，远远见[E2]围了大斗篷，带着灰鼠暖兜，坐着小竹轿，打着青绸油伞，[E1]琥珀等五六个丫鬟，每个人都是打着伞，拥轿而来	丫头
一一妥当，方过前边来[E2][E1]处问安吃饭	小儿媳
正值凤姐儿和[E2][E1]商议说：“天又短又冷，不如以后大嫂子带着姑娘们在园子里吃饭一样	小儿媳
”因此时[E1]李婶都在座，邢夫人及尤氏婆媳也都过来请安，还未过去，贾母向[E2]等说道：“今儿我才说这话，素日我不说，一则怕逞了凤丫头的脸，二则众人不伏	姐妹
”因此时薛姨妈李婶都在座，[E1]及尤氏婆媳也都过来请安，还未过去，[E2]向王夫人等说道：“今儿我才说这话，素日我不说，一则怕逞了凤丫头的脸，二则众人不伏	大儿媳
”因此时薛姨妈李婶都在座，邢夫人及尤氏婆媳也都过来请安，还未过去，[E2]向[E1]等说道：“今儿我才说这话，素日我不说，一则怕逞了凤丫头的脸，二则众人不伏	小儿媳
”因此时[E2]李婶都在座，邢夫人及尤氏婆媳也都过来请安，还未过去，贾母向[E1]等说道：“今儿我才说这话，素日我不说，一则怕逞了凤丫头的脸，二则众人不伏	姐妹
”因此时薛姨妈李婶都在座，[E2]及尤氏婆媳也都过来请安，还未过去，[E1]向王夫人等说道：“今儿我才说这话，素日我不说，一则怕逞了凤丫头的脸，二则众人不伏	婆婆
”因此时薛姨妈李婶都在座，邢夫人及[E1]婆媳也都过来请安，还未过去，[E2]向王夫人等说道：“今儿我才说这话，素日我不说，一则怕逞了凤丫头的脸，二则众人不伏	无关系
”因此时薛姨妈李婶都在座，[E1]及[E2]婆媳也都过来请安，还未过去，贾母向王夫人等说道：“今儿我才说这话，素日我不说，一则怕逞了凤丫头的脸，二则众人不伏	无关系
”因此时[E1]李婶都在座，邢夫人及尤氏婆媳也都过来请安，还未过去，[E2]向王夫人等说道：“今儿我才说这话，素日我不说，一则怕逞了凤丫头的脸，二则众人不伏	无关系
”因此时薛姨妈李婶都在座，[E1]及尤氏婆媳也都过来请安，还未过去，贾母向[E2]等说道：“今儿我才说这话，素日我不说，一则怕逞了凤丫头的脸，二则众人不伏	无关系
”因此时[E1]李婶都在座，邢夫人及[E2]婆媳也都过来请安，还未过去，贾母向王夫人等说道：“今儿我才说这话，素日我不说，一则怕逞了凤丫头的脸，二则众人不伏	无关系
”[E2]便命[E1]来：“把昨儿那一件乌云豹的氅衣给他罢	丫头
”[E1]一摔手，便进[E2]房中来了	丫头
宝玉只得到了[E1]房中，与[E1]看了，然后又回至园中，与晴雯麝月看过后，至[E2]房中回说：“太太看了，只说可惜了的，叫我仔细穿，别遭踏了他	小儿媳
宝玉只得到了王夫人房中，与王夫人看了，然后又回至园中，与[E1]麝月看过后，至[E2]房中回说：“太太看了，只说可惜了的，叫我仔细穿，别遭踏了他	无关系
一时[E1]进来吃饭，[E2]之妻回避了	父亲
一时[E2]进来吃饭，[E1]之妻回避了	儿子
[E2]因问[E1]：“咱们春祭的恩赏可领了不曾	妻
[E1]因问[E2]：“咱们春祭的恩赏可领了不曾	丈夫
”一面说，一面瞧那黄布口袋，上有印就是“皇恩永锡”四个大字，那一边又有礼部祠祭司的忧，又写着一行小字，道是“宁国公[E1]荣国公[E2]恩赐永远春祭赏共二分，净折银若干两，某年月日龙禁尉候补侍卫贾蓉当堂领讫，值年寺丞某人”，下面一个朱笔花押	兄弟
”一面说，一面瞧那黄布口袋，上有印就是“皇恩永锡”四个大字，那一边又有礼部祠祭司的忧，又写着一行小字，道是“宁国公[E1]荣国公贾源恩赐永远春祭赏共二分，净折银若干两，某年月日龙禁尉候补侍卫[E2]当堂领讫，值年寺丞某人”，下面一个朱笔花押	无关系
贾珍吃过饭，盥漱毕，换了靴帽，命贾蓉捧着银子跟了来，回过贾母王夫人，又至这边回过[E1][E2]，方回家去，取出银子，命将口袋向宗祠大炉内焚了	丈夫
[E1]吃过饭，盥漱毕，换了靴帽，命[E2]捧着银子跟了来，回过贾母王夫人，又至这边回过贾赦邢夫人，方回家去，取出银子，命将口袋向宗祠大炉内焚了	父亲
贾珍吃过饭，盥漱毕，换了靴帽，命贾蓉捧着银子跟了来，回过[E2]王夫人，又至这边回过贾赦[E1]，方回家去，取出银子，命将口袋向宗祠大炉内焚了	大儿媳
贾珍吃过饭，盥漱毕，换了靴帽，命贾蓉捧着银子跟了来，回过[E2][E1]，又至这边回过贾赦邢夫人，方回家去，取出银子，命将口袋向宗祠大炉内焚了	小儿媳
贾珍吃过饭，盥漱毕，换了靴帽，命贾蓉捧着银子跟了来，回过[E1]王夫人，又至这边回过[E2]邢夫人，方回家去，取出银子，命将口袋向宗祠大炉内焚了	母亲
贾珍吃过饭，盥漱毕，换了靴帽，命贾蓉捧着银子跟了来，回过[E1]王夫人，又至这边回过贾赦[E2]，方回家去，取出银子，命将口袋向宗祠大炉内焚了	婆婆
贾珍吃过饭，盥漱毕，换了靴帽，命贾蓉捧着银子跟了来，回过[E2]王夫人，又至这边回过[E1]邢夫人，方回家去，取出银子，命将口袋向宗祠大炉内焚了	儿子
[E2]吃过饭，盥漱毕，换了靴帽，命[E1]捧着银子跟了来，回过贾母王夫人，又至这边回过贾赦邢夫人，方回家去，取出银子，命将口袋向宗祠大炉内焚了	儿子
贾珍吃过饭，盥漱毕，换了靴帽，命贾蓉捧着银子跟了来，回过贾母王夫人，又至这边回过[E2][E1]，方回家去，取出银子，命将口袋向宗祠大炉内焚了	妻
[E1]吃过饭，盥漱毕，换了靴帽，命贾蓉捧着银子跟了来，回过贾母王夫人，又至这边回过贾赦[E2]，方回家去，取出银子，命将口袋向宗祠大炉内焚了	无关系
[E1]吃过饭，盥漱毕，换了靴帽，命贾蓉捧着银子跟了来，回过贾母[E2]，又至这边回过贾赦邢夫人，方回家去，取出银子，命将口袋向宗祠大炉内焚了	无关系
[E1]吃过饭，盥漱毕，换了靴帽，命贾蓉捧着银子跟了来，回过贾母王夫人，又至这边回过[E2]邢夫人，方回家去，取出银子，命将口袋向宗祠大炉内焚了	无关系
贾珍吃过饭，盥漱毕，换了靴帽，命[E1]捧着银子跟了来，回过[E2]王夫人，又至这边回过贾赦邢夫人，方回家去，取出银子，命将口袋向宗祠大炉内焚了	无关系
贾珍吃过饭，盥漱毕，换了靴帽，命贾蓉捧着银子跟了来，回过贾母[E1]，又至这边回过贾赦[E2]，方回家去，取出银子，命将口袋向宗祠大炉内焚了	无关系
贾珍吃过饭，盥漱毕，换了靴帽，命贾蓉捧着银子跟了来，回过贾母[E1]，又至这边回过[E2]邢夫人，方回家去，取出银子，命将口袋向宗祠大炉内焚了	无关系
贾珍吃过饭，盥漱毕，换了靴帽，命[E1]捧着银子跟了来，回过贾母王夫人，又至这边回过贾赦[E2]，方回家去，取出银子，命将口袋向宗祠大炉内焚了	无关系
[E1]吃过饭，盥漱毕，换了靴帽，命贾蓉捧着银子跟了来，回过[E2]王夫人，又至这边回过贾赦邢夫人，方回家去，取出银子，命将口袋向宗祠大炉内焚了	无关系
贾珍吃过饭，盥漱毕，换了靴帽，命[E1]捧着银子跟了来，回过贾母[E2]，又至这边回过贾赦邢夫人，方回家去，取出银子，命将口袋向宗祠大炉内焚了	无关系
”说着，[E2]接过禀帖和帐目，忙展开捧着，[E1]倒背着两手，向[E2]手内只看红禀帖上写着：“门下庄头乌进孝叩请爷、奶奶万福金安，并公子小姐金安	父亲
”说着，[E1]接过禀帖和帐目，忙展开捧着，[E2]倒背着两手，向[E1]手内只看红禀帖上写着：“门下庄头乌进孝叩请爷、奶奶万福金安，并公子小姐金安	儿子
”[E1]听了，笑向[E2]等道：“你们听，他这话可笑不可笑	父亲
”[E2]听了，笑向[E1]等道：“你们听，他这话可笑不可笑	儿子
”[E2]又笑向[E1]道：“果真那府里穷了	父亲
”[E1]又笑向[E2]道：“果真那府里穷了	儿子
这里[E1]吩咐将方才各物，留出供祖的来，将各样取了些，命[E2]送过荣府里	父亲
这里[E2]吩咐将方才各物，留出供祖的来，将各样取了些，命[E1]送过荣府里	儿子
”[E1]听说，忙命[E2]出去款待，“只说我不在家	父亲
”[E2]听说，忙命[E1]出去款待，“只说我不在家	儿子
”[E2]去了，这里[E1]看着领完东西，回房与尤氏吃毕晚饭，一宿无话	父亲
”贾蓉去了，这里[E2]看着领完东西，回房与[E1]吃毕晚饭，一宿无话	妻
”[E1]去了，这里[E2]看着领完东西，回房与尤氏吃毕晚饭，一宿无话	儿子
”贾蓉去了，这里[E1]看着领完东西，回房与[E2]吃毕晚饭，一宿无话	丈夫
”[E1]去了，这里贾珍看着领完东西，回房与[E2]吃毕晚饭，一宿无话	无关系
只见贾府人分昭穆排班立定：贾敬主祭，[E2]陪祭，贾珍献爵，[E1]贾琮献帛，宝玉捧香，贾菖贾菱展拜毯，守焚池	儿子
只见贾府人分昭穆排班立定：[E2]主祭，贾赦陪祭，[E1]献爵，贾琏贾琮献帛，宝玉捧香，贾菖贾菱展拜毯，守焚池	儿子
只见贾府人分昭穆排班立定：贾敬主祭，[E1]陪祭，贾珍献爵，[E2]贾琮献帛，宝玉捧香，贾菖贾菱展拜毯，守焚池	父亲
只见贾府人分昭穆排班立定：[E1]主祭，贾赦陪祭，[E2]献爵，贾琏贾琮献帛，宝玉捧香，贾菖贾菱展拜毯，守焚池	父亲
只见贾府人分昭穆排班立定：[E1]主祭，贾赦陪祭，贾珍献爵，[E2]贾琮献帛，宝玉捧香，贾菖贾菱展拜毯，守焚池	无关系
只见贾府人分昭穆排班立定：[E1]主祭，贾赦陪祭，贾珍献爵，贾琏贾琮献帛，宝玉捧香，贾菖[E2]展拜毯，守焚池	无关系
只见贾府人分昭穆排班立定：贾敬主祭，[E1]陪祭，贾珍献爵，贾琏贾琮献帛，宝玉捧香，贾菖[E2]展拜毯，守焚池	无关系
只见贾府人分昭穆排班立定：贾敬主祭，[E1]陪祭，[E2]献爵，贾琏贾琮献帛，宝玉捧香，贾菖贾菱展拜毯，守焚池	无关系
[E1]传于[E2]，[E2]方捧放在桌上	小儿媳
[E1]在供桌之西，东向立，同[E2]供放	大儿媳
[E2]在供桌之西，东向立，同[E1]供放	婆婆
凡从文旁之名者，贾敬为首，下则从玉者，[E1]为首，再下从草头者，[E2]为首，左昭右穆，男东女西，俟贾母拈香下拜，众人方一齐跪下，将五间大厅，三间抱厦，内外廊檐，阶上阶下两丹墀内，花团锦簇，塞的无一隙空地	父亲
凡从文旁之名者，贾敬为首，下则从玉者，[E2]为首，再下从草头者，[E1]为首，左昭右穆，男东女西，俟贾母拈香下拜，众人方一齐跪下，将五间大厅，三间抱厦，内外廊檐，阶上阶下两丹墀内，花团锦簇，塞的无一隙空地	儿子
凡从文旁之名者，[E2]为首，下则从玉者，[E1]为首，再下从草头者，贾蓉为首，左昭右穆，男东女西，俟贾母拈香下拜，众人方一齐跪下，将五间大厅，三间抱厦，内外廊檐，阶上阶下两丹墀内，花团锦簇，塞的无一隙空地	儿子
凡从文旁之名者，[E1]为首，下则从玉者，[E2]为首，再下从草头者，贾蓉为首，左昭右穆，男东女西，俟贾母拈香下拜，众人方一齐跪下，将五间大厅，三间抱厦，内外廊檐，阶上阶下两丹墀内，花团锦簇，塞的无一隙空地	父亲
凡从文旁之名者，贾敬为首，下则从玉者，贾珍为首，再下从草头者，[E1]为首，左昭右穆，男东女西，俟[E2]拈香下拜，众人方一齐跪下，将五间大厅，三间抱厦，内外廊檐，阶上阶下两丹墀内，花团锦簇，塞的无一隙空地	无关系
凡从文旁之名者，[E1]为首，下则从玉者，贾珍为首，再下从草头者，[E2]为首，左昭右穆，男东女西，俟贾母拈香下拜，众人方一齐跪下，将五间大厅，三间抱厦，内外廊檐，阶上阶下两丹墀内，花团锦簇，塞的无一隙空地	无关系
凡从文旁之名者，贾敬为首，下则从玉者，[E1]为首，再下从草头者，贾蓉为首，左昭右穆，男东女西，俟[E2]拈香下拜，众人方一齐跪下，将五间大厅，三间抱厦，内外廊檐，阶上阶下两丹墀内，花团锦簇，塞的无一隙空地	无关系
凡从文旁之名者，[E1]为首，下则从玉者，贾珍为首，再下从草头者，贾蓉为首，左昭右穆，男东女西，俟[E2]拈香下拜，众人方一齐跪下，将五间大厅，三间抱厦，内外廊檐，阶上阶下两丹墀内，花团锦簇，塞的无一隙空地	无关系
一时礼毕，贾敬[E1]等便忙退出，至荣府专候与[E2]行礼	儿子
一时礼毕，贾敬[E2]等便忙退出，至荣府专候与[E1]行礼	母亲
一时礼毕，[E1]贾赦等便忙退出，至荣府专候与[E2]行礼	无关系
一时礼毕，[E1][E2]等便忙退出，至荣府专候与贾母行礼	无关系
尤氏用茶盘亲捧茶与[E2]，蓉妻捧与众老祖母，然后尤氏又捧与[E1]等，蓉妻又捧与众姊妹	大儿媳
尤氏用茶盘亲捧茶与[E1]，蓉妻捧与众老祖母，然后尤氏又捧与[E2]等，蓉妻又捧与众姊妹	婆婆
[E1]用茶盘亲捧茶与贾母，蓉妻捧与众老祖母，然后[E1]又捧与[E2]等，蓉妻又捧与众姊妹	无关系
[E1]用茶盘亲捧茶与[E2]，蓉妻捧与众老祖母，然后[E1]又捧与邢夫人等，蓉妻又捧与众姊妹	无关系
茶毕，[E1]等便先起身来侍[E2]	大儿媳
茶毕，[E2]等便先起身来侍[E1]	婆婆
十一日是[E1]请[E2]等，次日贾珍又请，[E2]皆去随便领了半日	儿子
十一日是[E2]请[E1]等，次日贾珍又请，[E1]皆去随便领了半日	母亲
十一日是贾赦请[E1]等，次日[E2]又请，[E1]皆去随便领了半日	无关系
十一日是[E1]请贾母等，次日[E2]又请，贾母皆去随便领了半日	无关系
[E1]略领了[E2]之赐，也便告辞而去	儿子
[E2]略领了[E1]之赐，也便告辞而去	母亲
廊上几席，便是[E1]、贾琏、贾环、贾琮、[E2]、贾芹、贾芸、贾菱、贾菖等	父亲
廊上几席，便是[E2]、贾琏、贾环、贾琮、[E1]、贾芹、贾芸、贾菱、贾菖等	儿子
廊上几席，便是贾珍、贾琏、[E1]、贾琮、[E2]、贾芹、贾芸、贾菱、贾菖等	无关系
廊上几席，便是贾珍、贾琏、[E1]、贾琮、贾蓉、贾芹、贾芸、贾菱、[E2]等	无关系
却说贾珍[E2]暗暗预备下大簸箩的钱，听见贾母说“赏”，他们也忙命小厮们快撒钱	妻
却说贾珍[E1]暗暗预备下大簸箩的钱，听见贾母说“赏”，他们也忙命小厮们快撒钱	丈夫
却说贾珍[E1]暗暗预备下大簸箩的钱，听见[E2]说“赏”，他们也忙命小厮们快撒钱	无关系
却说[E1]贾琏暗暗预备下大簸箩的钱，听见[E2]说“赏”，他们也忙命小厮们快撒钱	无关系
”于是邢夫人王夫人之中夹着宝玉，宝钗等姊妹在西边，挨次下去便是娄氏带着贾菌，尤氏[E2]夹着[E1]，下面横头便是贾蓉之妻	儿子
”于是邢夫人王夫人之中夹着宝玉，宝钗等姊妹在西边，挨次下去便是娄氏带着贾菌，[E1]李纨夹着贾兰，下面横头便是[E2]之妻	无关系
[E1]禀气柔弱，不禁毕驳之声，[E2]便搂他在怀中	外孙女
[E2]禀气柔弱，不禁毕驳之声，[E1]便搂他在怀中	外祖母
凡诸亲友来请或来赴席的，[E2]一概怕拘束不会，自有[E1]、王夫人、凤姐儿三人料理	大儿媳
凡诸亲友来请或来赴席的，[E1]一概怕拘束不会，自有[E2]、王夫人、凤姐儿三人料理	婆婆
凡诸亲友来请或来赴席的，[E2]一概怕拘束不会，自有邢夫人、[E1]、凤姐儿三人料理	小儿媳
凡诸亲友来请或来赴席的，贾母一概怕拘束不会，自有[E1]、[E2]、凤姐儿三人料理	无关系
四人告辞了[E2]，便往[E1]处来	小儿媳
谁知[E2][E1]等已都在那里了	小儿媳
[E2]一见了[E1]，眼内出火，骂道：“你这小蹄子，和他说了什么	丫头
[E2]便拉住[E1]，只当他得罪了宝玉，所以拉[E1]命他打	丫头
[E2]、[E1]、宝钗等暂避里间，贾母便端坐在宝玉身旁，王太医进来见许多的人，忙上去请了贾母的安，拿了宝玉的手诊了一回	姐妹
[E1]、[E2]、宝钗等暂避里间，贾母便端坐在宝玉身旁，王太医进来见许多的人，忙上去请了贾母的安，拿了宝玉的手诊了一回	姐妹
[E1]、薛姨妈、宝钗等暂避里间，[E2]便端坐在宝玉身旁，王太医进来见许多的人，忙上去请了[E2]的安，拿了宝玉的手诊了一回	小儿媳
王夫人、[E1]、宝钗等暂避里间，[E2]便端坐在宝玉身旁，王太医进来见许多的人，忙上去请了[E2]的安，拿了宝玉的手诊了一回	无关系
[E2][E1]无法，只得命紫鹃守着他，另将琥珀去伏侍黛玉	小儿媳
[E2]王夫人无法，只得命[E1]守着他，另将琥珀去伏侍黛玉	丫头
贾母[E1]无法，只得命[E2]守着他，另将琥珀去伏侍黛玉	无关系
晚间宝玉稍安，[E2][E1]等方回房去	小儿媳
今见[E1]来了，问其原故，已知大愈，仍遣琥珀去伏侍[E2]	丫头
是日也定了一本小戏请[E2][E1]等，独有宝玉与黛玉二人不曾去得	小儿媳
次日，[E2]家又命[E1]陪诸伙计吃了一天酒，连忙了三四天方完备	侄儿
[E1]想了一想：薛家根基不错，且现今大富，薛蝌生得又好，且[E2]硬作保山，将机就计便应了	大儿媳
[E2]想了一想：薛家根基不错，且现今大富，薛蝌生得又好，且[E1]硬作保山，将机就计便应了	婆婆
[E1]想了一想：薛家根基不错，且现今大富，[E2]生得又好，且贾母硬作保山，将机就计便应了	无关系
邢夫人想了一想：薛家根基不错，且现今大富，[E1]生得又好，且[E2]硬作保山，将机就计便应了	无关系
尤氏深知[E1]情性，本不欲管，无奈[E2]亲嘱咐，只得应了，惟有忖度[E1]之意行事	大儿媳
尤氏深知[E2]情性，本不欲管，无奈[E1]亲嘱咐，只得应了，惟有忖度[E2]之意行事	婆婆
[E1]深知[E2]情性，本不欲管，无奈贾母亲嘱咐，只得应了，惟有忖度[E2]之意行事	无关系
[E1]深知邢夫人情性，本不欲管，无奈[E2]亲嘱咐，只得应了，惟有忖度邢夫人之意行事	无关系
[E1]本欲接出岫烟去住，[E2]因说：“这又何妨，两个孩子又不能见面，就是姨太太和他一个大姑，一个小姑，又何妨	大儿媳
[E2]本欲接出岫烟去住，[E1]因说：“这又何妨，两个孩子又不能见面，就是姨太太和他一个大姑，一个小姑，又何妨	婆婆
因宝钗处有湘云香菱；李纨处目今李婶母女虽去，然有时亦来住三五日不定，[E2]又将宝琴送与他去照管；迎春处有岫烟；探春因家务冗杂，且不时有赵姨娘与贾环来嘈聒，甚不方便；惜春处房屋狭小；况[E2]又千叮咛万嘱咐托他照管[E1]，薛姨妈素习也最怜爱他的，今既巧遇这事，便挪至潇湘馆来和黛玉同房，一应药饵饮食十分经心	外孙女
因宝钗处有湘云香菱；李纨处目今李婶母女虽去，然有时亦来住三五日不定，[E1]又将宝琴送与他去照管；迎春处有岫烟；探春因家务冗杂，且不时有赵姨娘与贾环来嘈聒，甚不方便；惜春处房屋狭小；况[E1]又千叮咛万嘱咐托他照管[E2]，薛姨妈素习也最怜爱他的，今既巧遇这事，便挪至潇湘馆来和黛玉同房，一应药饵饮食十分经心	外祖母
因宝钗处有湘云香菱；李纨处目今李婶母女虽去，然有时亦来住三五日不定，贾母又将宝琴送与他去照管；迎春处有岫烟；探春因家务冗杂，且不时有[E1]与[E2]来嘈聒，甚不方便；惜春处房屋狭小；况贾母又千叮咛万嘱咐托他照管林黛玉，薛姨妈素习也最怜爱他的，今既巧遇这事，便挪至潇湘馆来和黛玉同房，一应药饵饮食十分经心	母亲
因宝钗处有湘云香菱；李纨处目今李婶母女虽去，然有时亦来住三五日不定，贾母又将宝琴送与他去照管；迎春处有岫烟；探春因家务冗杂，且不时有[E2]与[E1]来嘈聒，甚不方便；惜春处房屋狭小；况贾母又千叮咛万嘱咐托他照管林黛玉，薛姨妈素习也最怜爱他的，今既巧遇这事，便挪至潇湘馆来和黛玉同房，一应药饵饮食十分经心	儿子
因宝钗处有湘云[E1]；李纨处目今李婶母女虽去，然有时亦来住三五日不定，贾母又将宝琴送与他去照管；迎春处有岫烟；探春因家务冗杂，且不时有[E2]与贾环来嘈聒，甚不方便；惜春处房屋狭小；况贾母又千叮咛万嘱咐托他照管林黛玉，薛姨妈素习也最怜爱他的，今既巧遇这事，便挪至潇湘馆来和黛玉同房，一应药饵饮食十分经心	无关系
因宝钗处有湘云香菱；李纨处目今李婶母女虽去，然有时亦来住三五日不定，贾母又将宝琴送与他去照管；迎春处有岫烟；探春因家务冗杂，且不时有赵姨娘与贾环来嘈聒，甚不方便；惜春处房屋狭小；况贾母又千叮咛万嘱咐托他照管[E1]，[E2]素习也最怜爱他的，今既巧遇这事，便挪至潇湘馆来和黛玉同房，一应药饵饮食十分经心	无关系
因宝钗处有湘云[E1]；李纨处目今李婶母女虽去，然有时亦来住三五日不定，贾母又将宝琴送与他去照管；迎春处有岫烟；探春因家务冗杂，且不时有赵姨娘与贾环来嘈聒，甚不方便；惜春处房屋狭小；况贾母又千叮咛万嘱咐托他照管林黛玉，[E2]素习也最怜爱他的，今既巧遇这事，便挪至潇湘馆来和黛玉同房，一应药饵饮食十分经心	无关系
因宝钗处有湘云香菱；李纨处目今李婶母女虽去，然有时亦来住三五日不定，贾母又将宝琴送与他去照管；迎春处有岫烟；探春因家务冗杂，且不时有[E1]与贾环来嘈聒，甚不方便；惜春处房屋狭小；况贾母又千叮咛万嘱咐托他照管林黛玉，[E2]素习也最怜爱他的，今既巧遇这事，便挪至潇湘馆来和黛玉同房，一应药饵饮食十分经心	无关系
尤氏虽天天过来，也不过应名点卯，亦不肯乱作威福，且他家内上下也只剩他一个料理，再者每日还要照管[E2][E1]的下处一应所需饮馔铺设之物，所以也甚操劳	小儿媳
[E1]虽天天过来，也不过应名点卯，亦不肯乱作威福，且他家内上下也只剩他一个料理，再者每日还要照管贾母[E2]的下处一应所需饮馔铺设之物，所以也甚操劳	无关系
且说大观园中因[E2][E1]天天不在家内，又送灵去一月方回，各丫鬟婆子皆有闲空，多在园中游玩	小儿媳
离送灵日不远，[E1]、琥珀、翡翠、玻璃四人都忙着打点[E2]之物，玉钏、彩云、彩霞等皆打叠王夫人之物，当面查点与跟随的管事媳妇们	丫头
离送灵日不远，鸳鸯、琥珀、翡翠、玻璃四人都忙着打点贾母之物，玉钏、[E1]、彩霞等皆打叠[E2]之物，当面查点与跟随的管事媳妇们	大丫头
离送灵日不远，鸳鸯、琥珀、翡翠、玻璃四人都忙着打点[E2]之物，玉钏、彩云、彩霞等皆打叠[E1]之物，当面查点与跟随的管事媳妇们	小儿媳
离送灵日不远，鸳鸯、琥珀、翡翠、玻璃四人都忙着打点贾母之物，玉钏、彩云、[E1]等皆打叠[E2]之物，当面查点与跟随的管事媳妇们	大丫头
离送灵日不远，鸳鸯、琥珀、翡翠、玻璃四人都忙着打点[E1]之物，玉钏、[E2]、彩霞等皆打叠王夫人之物，当面查点与跟随的管事媳妇们	无关系
离送灵日不远，鸳鸯、琥珀、翡翠、玻璃四人都忙着打点[E1]之物，玉钏、彩云、[E2]等皆打叠王夫人之物，当面查点与跟随的管事媳妇们	无关系
离送灵日不远，鸳鸯、琥珀、翡翠、玻璃四人都忙着打点贾母之物，玉钏、[E1]、[E2]等皆打叠王夫人之物，当面查点与跟随的管事媳妇们	无关系
离送灵日不远，[E1]、琥珀、翡翠、玻璃四人都忙着打点贾母之物，玉钏、[E2]、彩霞等皆打叠王夫人之物，当面查点与跟随的管事媳妇们	无关系
临日，[E2]带着蓉妻坐一乘驮轿，[E1]在后亦坐一乘驮轿，贾珍骑马率了众家丁护卫	小儿媳
临日，[E1]带着蓉妻坐一乘驮轿，王夫人在后亦坐一乘驮轿，[E2]骑马率了众家丁护卫	无关系
贾琏恐路上不便，一面打发了他父母起身赶上[E2][E1]驮轿，自己也随后带领家丁押后跟来	小儿媳
[E1]恐路上不便，一面打发了他父母起身赶上[E2]王夫人驮轿，自己也随后带领家丁押后跟来	无关系
园中前后东西角门亦皆关锁，只留[E2]大房之后常系他姊妹出入之门，东边通[E1]的角门，这两门因在内院，不必关锁	姐妹
园中前后东西角门亦皆关锁，只留[E1]大房之后常系他姊妹出入之门，东边通[E2]的角门，这两门因在内院，不必关锁	姐妹
原来[E2]不在家，且王夫人等又不在家，[E1]连日也便装病逃学	儿子
原来[E1]不在家，且王夫人等又不在家，[E2]连日也便装病逃学	父亲
原来[E1]不在家，且[E2]等又不在家，贾环连日也便装病逃学	丈夫
原来[E2]不在家，且[E1]等又不在家，贾环连日也便装病逃学	妻
原来贾政不在家，且[E1]等又不在家，[E2]连日也便装病逃学	无关系
正值彩云和[E1]闲谈，[E2]嘻嘻向彩云道：“我也得了一包好的，送你檫脸	母亲
正值彩云和[E2]闲谈，[E1]嘻嘻向彩云道：“我也得了一包好的，送你檫脸	儿子
正值[E1]和赵姨娘闲谈，[E2]嘻嘻向[E1]道：“我也得了一包好的，送你檫脸	无关系
正值[E1]和[E2]闲谈，贾环嘻嘻向[E1]道：“我也得了一包好的，送你檫脸	无关系
[E1]悉将芳官以粉作硝轻侮[E2]之事说了	母亲
[E2]悉将芳官以粉作硝轻侮[E1]之事说了	儿子
[E1]悉将[E2]以粉作硝轻侮贾环之事说了	无关系
赵姨娘悉将[E1]以粉作硝轻侮[E2]之事说了	无关系
行毕礼，奠茶焚纸后，便至宁府中宗祠祖先堂两处行毕礼，出至月台上，又朝上遥拜过[E2]，[E1]，王夫人等	儿子
行毕礼，奠茶焚纸后，便至宁府中宗祠祖先堂两处行毕礼，出至月台上，又朝上遥拜过贾母，[E1]，[E2]等	丈夫
行毕礼，奠茶焚纸后，便至宁府中宗祠祖先堂两处行毕礼，出至月台上，又朝上遥拜过[E2]，贾政，[E1]等	小儿媳
行毕礼，奠茶焚纸后，便至宁府中宗祠祖先堂两处行毕礼，出至月台上，又朝上遥拜过贾母，[E2]，[E1]等	妻
先至[E2]处，[E2]再三拉着，然后又遇见[E1]，让一回，方进园来	侄儿
这些人因[E2][E1]不在家，没了管束，便任意取乐，呼三喝四，喊七叫八	小儿媳
”[E1]一闻此言，又见[E2]父子并贾琏等皆不在家，一时竟没个着己的男子来，未免忙了	妻
”[E2]一闻此言，又见[E1]父子并贾琏等皆不在家，一时竟没个着己的男子来，未免忙了	丈夫
”[E1]一闻此言，又见贾珍父子并[E2]等皆不在家，一时竟没个着己的男子来，未免忙了	无关系
”尤氏一闻此言，又见[E1]父子并[E2]等皆不在家，一时竟没个着己的男子来，未免忙了	无关系
”[E1]也不听，只命锁着，等[E2]来发放，且命人去飞马报信	妻
”[E2]也不听，只命锁着，等[E1]来发放，且命人去飞马报信	丈夫
且说[E1]闻了此信，即忙告假，并[E2]是有职之人	父亲
且说[E2]闻了此信，即忙告假，并[E1]是有职之人	儿子
[E2]当下也下了马，听见两个姨娘来了，便和[E1]一笑	父亲
[E1]当下也下了马，听见两个姨娘来了，便和[E2]一笑	儿子
[E1]下了马，和[E2]放声大哭，从大门外便跪爬进来，至棺前稽颡泣血，直哭到天亮喉咙都哑了方住	父亲
[E2]下了马，和[E1]放声大哭，从大门外便跪爬进来，至棺前稽颡泣血，直哭到天亮喉咙都哑了方住	儿子
话说[E2]见家中诸事已妥，连忙赶至寺中，回明[E1]	父亲
话说[E1]见家中诸事已妥，连忙赶至寺中，回明[E2]	儿子
[E1][E2]此时为礼法所拘，不免在灵旁籍草枕块，恨苦居丧	父亲
[E2][E1]此时为礼法所拘，不免在灵旁籍草枕块，恨苦居丧	儿子
于是宝玉先迎着贾琏跪下，口中给[E2][E1]等请了安	小儿媳
于是宝玉先迎着[E1]跪下，口中给[E2]王夫人等请了安	无关系
至次日饭时前后，果见[E2][E1]等到来	小儿媳
只听见里面哭声震天，却是[E1]贾琏送[E2]到家即过这边来了	儿子
只听见里面哭声震天，却是[E2][E1]送贾母到家即过这边来了	儿子
只听见里面哭声震天，却是[E1][E2]送贾母到家即过这边来了	父亲
只听见里面哭声震天，却是[E2]贾琏送[E1]到家即过这边来了	母亲
只听见里面哭声震天，却是贾赦[E1]送[E2]到家即过这边来了	无关系
当下[E2]进入里面，早有[E1]贾琏率领族中人哭着迎了出来	儿子
当下贾母进入里面，早有[E2][E1]率领族中人哭着迎了出来	儿子
当下贾母进入里面，早有[E1][E2]率领族中人哭着迎了出来	父亲
当下[E1]进入里面，早有[E2]贾琏率领族中人哭着迎了出来	母亲
当下[E1]进入里面，早有贾赦[E2]率领族中人哭着迎了出来	无关系
他父子一边一个挽了贾母，走至灵前，又有[E1][E2]跪着扑入贾母怀中痛哭	父亲
他父子一边一个挽了贾母，走至灵前，又有[E2][E1]跪着扑入贾母怀中痛哭	儿子
他父子一边一个挽了[E1]，走至灵前，又有[E2]贾蓉跪着扑入[E1]怀中痛哭	无关系
他父子一边一个挽了[E1]，走至灵前，又有贾珍[E2]跪着扑入[E1]怀中痛哭	无关系
[E2][E1]在旁苦劝，方略略止住	儿子
[E1][E2]在旁苦劝，方略略止住	父亲
贾珍因[E2]才回家来，未得歇息，坐在此间，看着未免要伤心，遂再三求[E2]回家，[E1]等亦再三相劝	小儿媳
[E1]因[E2]才回家来，未得歇息，坐在此间，看着未免要伤心，遂再三求[E2]回家，王夫人等亦再三相劝	无关系
其余[E2]，[E1]，邢夫人，王夫人等率领家人仆妇，都送至铁槛寺，至晚方回	儿子
其余[E2]，贾琏，[E1]，王夫人等率领家人仆妇，都送至铁槛寺，至晚方回	妻
其余[E1]，[E2]，邢夫人，王夫人等率领家人仆妇，都送至铁槛寺，至晚方回	父亲
其余[E1]，贾琏，[E2]，王夫人等率领家人仆妇，都送至铁槛寺，至晚方回	丈夫
其余[E1]，贾琏，邢夫人，[E2]等率领家人仆妇，都送至铁槛寺，至晚方回	无关系
其余贾赦，[E1]，[E2]，王夫人等率领家人仆妇，都送至铁槛寺，至晚方回	无关系
其余贾赦，贾琏，[E1]，[E2]等率领家人仆妇，都送至铁槛寺，至晚方回	无关系
其余贾赦，[E1]，邢夫人，[E2]等率领家人仆妇，都送至铁槛寺，至晚方回	无关系
[E1]尤氏并[E2]仍在寺中守灵，等过百日后，方扶柩回籍	父亲
[E2][E1]并贾蓉仍在寺中守灵，等过百日后，方扶柩回籍	妻
[E2]尤氏并[E1]仍在寺中守灵，等过百日后，方扶柩回籍	儿子
[E1][E2]并贾蓉仍在寺中守灵，等过百日后，方扶柩回籍	丈夫
贾珍[E1]并[E2]仍在寺中守灵，等过百日后，方扶柩回籍	无关系
况知与[E1][E2]等素有聚..之诮，因而乘机百般撩拨，眉目传情	父亲
况知与[E2][E1]等素有聚..之诮，因而乘机百般撩拨，眉目传情	儿子
”[E1]想了一回，向[E2]道：“你问你娘去，昨日出殡以后，有江南甄家送来打祭银五百两，未曾交到库上去，你先要了来，给他去罢	父亲
”[E2]想了一回，向[E1]道：“你问你娘去，昨日出殡以后，有江南甄家送来打祭银五百两，未曾交到库上去，你先要了来，给他去罢	儿子
”[E1]又吩咐[E2]道：“你跟了你叔叔去，也到那边给老太太、老爷、太太们请安，说我和你娘都请安，打听打听老太太身上可大安了	父亲
”[E2]又吩咐[E1]道：“你跟了你叔叔去，也到那边给老太太、老爷、太太们请安，说我和你娘都请安，打听打听老太太身上可大安了	儿子
在路叔侄闲话，[E2]有心，便提到[E1]，因夸说如何标致，如何做人好，举止大方，言语温柔，无一处不令人可敬可爱，“人人都说你婶子好，据我看那里及你二姨一零儿呢	二房
却不知[E2]亦非好意，素日因同他姨娘有情，只因[E1]在内，不能畅意	父亲
却不知[E1]亦非好意，素日因同他姨娘有情，只因[E2]在内，不能畅意	儿子
[E2]进入房中一看，只见南边炕上只有[E1]带着两个丫鬟一处做活，却不见尤老娘与三姐	二房
[E2]送目与二姐，令其拾取，这[E1]亦只是不理	二房
一面给[E1]请安，又给[E2]去请安不提	儿子
一面给[E2]请安，又给[E1]去请安不提	母亲
”说毕，又趁便将路上[E2]要娶[E1]做二房之意说了	二房
贾琏自是喜出望外，感谢[E1][E2]父子不尽	父亲
贾琏自是喜出望外，感谢[E2][E1]父子不尽	儿子
[E1]自是喜出望外，感谢贾珍[E2]父子不尽	无关系
[E1]自是喜出望外，感谢[E2]贾蓉父子不尽	无关系
话说贾琏[E1][E2]等三人商议，事事妥贴，至初二日，先将尤老和三姐送入新房	父亲
话说贾琏[E2][E1]等三人商议，事事妥贴，至初二日，先将尤老和三姐送入新房	儿子
话说[E1]贾珍贾蓉等三人商议，事事妥贴，至初二日，先将[E2]和三姐送入新房	无关系
话说贾琏[E1]贾蓉等三人商议，事事妥贴，至初二日，先将[E2]和三姐送入新房	无关系
[E2]进来，屋内才点灯，先看过了[E1]母女，然后二姐出见，[E2]仍唤二姨	妻
[E1]进来，屋内才点灯，先看过了[E2]母女，然后二姐出见，[E1]仍唤二姨	丈夫
[E1]听见马闹，心下便不自安，只管用言语混乱[E2]	二房
自此后，或略有丫鬟婆娘不到之处，便将贾琏、[E1]、[E2]三个泼声厉言痛骂，说他爷儿三个诓骗了他寡妇孤女	父亲
自此后，或略有丫鬟婆娘不到之处，便将贾琏、[E2]、[E1]三个泼声厉言痛骂，说他爷儿三个诓骗了他寡妇孤女	儿子
自此后，或略有丫鬟婆娘不到之处，便将[E1]、贾珍、[E2]三个泼声厉言痛骂，说他爷儿三个诓骗了他寡妇孤女	无关系
自此后，或略有丫鬟婆娘不到之处，便将[E1]、[E2]、贾蓉三个泼声厉言痛骂，说他爷儿三个诓骗了他寡妇孤女	无关系
”[E2]才要又问，忽见[E1]笑问道：“可是你们家那宝玉，除了上学，他作些什么	妹妹
”[E2]问是谁，[E1]笑道：“这人此刻不在这里，不知多早才来，也难为他眼力	二房
谁知[E2]出门之后，[E1]操持家务十分谨肃，每日关门闭户，一点外事不闻	二房
谁知八月内湘莲方进了京，先来拜见[E2]，又遇见薛蝌，方知[E1]不惯风霜，不服水土，一进京时便病倒在家，请医调治	儿子
谁知八月内湘莲方进了京，先来拜见[E2]，又遇见[E1]，方知薛蟠不惯风霜，不服水土，一进京时便病倒在家，请医调治	侄儿
谁知八月内湘莲方进了京，先来拜见[E1]，又遇见薛蝌，方知[E2]不惯风霜，不服水土，一进京时便病倒在家，请医调治	母亲
谁知八月内湘莲方进了京，先来拜见薛姨妈，又遇见[E1]，方知[E2]不惯风霜，不服水土，一进京时便病倒在家，请医调治	无关系
[E1]忙止泪反劝[E2]：“你太多事，人家并没威逼他死，是他自寻短见	二房
”[E2]道：“妈妈可听见说[E1]跟着一个道士出了家了么	好兄弟
这里[E1]将箱子里的东西取出，一分一分的打点清楚，叫同喜送给贾母并[E2]等处不提	姐妹
这里[E2]将箱子里的东西取出，一分一分的打点清楚，叫同喜送给贾母并[E1]等处不提	姐妹
这里薛姨妈将箱子里的东西取出，一分一分的打点清楚，叫同喜送给[E2]并[E1]等处不提	小儿媳
这里[E1]将箱子里的东西取出，一分一分的打点清楚，叫同喜送给[E2]并王夫人等处不提	无关系
且说[E1]因见宝钗送了[E2]些东西，心中甚是喜欢，想道：“怨不得别人都说那宝丫头好，会做人，很大方，如今看起来果然不错	母亲
且说[E2]因见宝钗送了[E1]些东西，心中甚是喜欢，想道：“怨不得别人都说那宝丫头好，会做人，很大方，如今看起来果然不错	儿子
至十四日便回明[E2][E1]，说十五日一早要到姑子庙进香去	小儿媳
且说[E2]等正忙着[E1]之事，忽有人来报信，说有人告你们如此如此，这般这般，快作道理	父亲
且说[E1]等正忙着[E2]之事，忽有人来报信，说有人告你们如此如此，这般这般，快作道理	儿子
[E2]慌了，忙来回[E1]	父亲
[E1]慌了，忙来回[E2]	儿子
”[E1]听了这个，倒吃了一惊，忙要同[E2]藏躲	父亲
”[E2]听了这个，倒吃了一惊，忙要同[E1]藏躲	儿子
”[E2]又戴了眼镜，命[E1]琥珀：“把那孩子拉过来，我瞧瞧肉皮儿	丫头
[E2]依允，遂使二人带去见了[E1]等	大儿媳
[E1]依允，遂使二人带去见了[E2]等	婆婆
[E2]深知凤姐之意，若要使张华领回，成何体统，便回了[E1]，暗暗遣人去说张华：“你如今既有许多银子，何必定要原人	父亲
[E1]深知凤姐之意，若要使张华领回，成何体统，便回了[E2]，暗暗遣人去说张华：“你如今既有许多银子，何必定要原人	儿子
少不得来见[E2]与[E1]，将所完之事回明	妻
少不得来见[E1]与[E2]，将所完之事回明	丈夫
[E2]十分欢喜，说他中用，赏了他一百两银子，又将房中一个十七岁的丫鬟名唤[E1]者，赏他为妾	丫环
[E2]十分欢喜，说他中用，赏了他一百两银子，又将房中一个十七岁的丫鬟名唤[E1]者，赏他为妾	妾
一面又命摆酒接风，一面带了秋桐来见[E2]与[E1]等	小儿媳
一面又命摆酒接风，一面带了[E1]来见贾母与[E2]等	无关系
[E1]自为系[E2]之赐，无人僭他的，连凤姐平儿皆不放在眼里，岂肯容他	丫环
[E1]自为系[E2]之赐，无人僭他的，连凤姐平儿皆不放在眼里，岂肯容他	妾
况素习以来因[E2]姬妾丫鬟最多，[E1]每怀不轨之心，只未敢下手	儿子
况素习以来因[E1]姬妾丫鬟最多，[E2]每怀不轨之心，只未敢下手	父亲
甚至于与[E1]眉来眼去相偷期的，只惧[E2]之威，未曾到手	儿子
甚至于与[E2]眉来眼去相偷期的，只惧[E1]之威，未曾到手	父亲
气的[E1]在房里哭泣，饭也不吃，又不敢告诉[E2]	二房
秋桐正是抓乖卖俏之时，他便悄悄的告诉[E2][E1]等说：“专会作死，好好的成天家号丧，背地里咒二奶奶和我早死了，他好和二爷一心一计的过	小儿媳
[E1]正是抓乖卖俏之时，他便悄悄的告诉贾母[E2]等说：“专会作死，好好的成天家号丧，背地里咒二奶奶和我早死了，他好和二爷一心一计的过	无关系
”[E2]无法，只得命将帐子掀起一缝，[E1]露出脸来	二房
秋桐近见[E2]请医治药，打人骂狗，为[E1]十分尽心，他心中早浸了一缸醋在内了	二房
[E1]近见贾琏请医治药，打人骂狗，为[E2]十分尽心，他心中早浸了一缸醋在内了	无关系
话说贾琏自在梨香院伴宿七日夜，天天僧道不断做佛事	朋友
凤姐看了，先来问[E2]和[E1]	小儿媳
[E2]和王夫人命宝玉，探春，[E1]，宝钗四人同凤姐去	外孙女
[E1]和王夫人命宝玉，探春，[E2]，宝钗四人同凤姐去	外祖母
[E2]和[E1]命宝玉，探春，林黛玉，宝钗四人同凤姐去	小儿媳
贾母和[E1]命宝玉，探春，[E2]，宝钗四人同凤姐去	无关系
因今岁八月初三日乃[E2]八旬之庆，又因亲友全来，恐筵宴排设不开，便早同[E1]及贾珍贾琏等商议，议定于七月二十八日起至八月初五日止荣宁两处齐开筵宴，宁国府中单请官客，荣国府中单请堂客，大观园中收拾出缀锦阁并嘉荫堂等几处大地方来作退居	儿子
因今岁八月初三日乃贾母八旬之庆，又因亲友全来，恐筵宴排设不开，便早同[E2]及贾珍[E1]等商议，议定于七月二十八日起至八月初五日止荣宁两处齐开筵宴，宁国府中单请官客，荣国府中单请堂客，大观园中收拾出缀锦阁并嘉荫堂等几处大地方来作退居	儿子
因今岁八月初三日乃贾母八旬之庆，又因亲友全来，恐筵宴排设不开，便早同[E1]及贾珍[E2]等商议，议定于七月二十八日起至八月初五日止荣宁两处齐开筵宴，宁国府中单请官客，荣国府中单请堂客，大观园中收拾出缀锦阁并嘉荫堂等几处大地方来作退居	父亲
因今岁八月初三日乃[E1]八旬之庆，又因亲友全来，恐筵宴排设不开，便早同[E2]及贾珍贾琏等商议，议定于七月二十八日起至八月初五日止荣宁两处齐开筵宴，宁国府中单请官客，荣国府中单请堂客，大观园中收拾出缀锦阁并嘉荫堂等几处大地方来作退居	母亲
因今岁八月初三日乃贾母八旬之庆，又因亲友全来，恐筵宴排设不开，便早同[E1]及[E2]贾琏等商议，议定于七月二十八日起至八月初五日止荣宁两处齐开筵宴，宁国府中单请官客，荣国府中单请堂客，大观园中收拾出缀锦阁并嘉荫堂等几处大地方来作退居	无关系
因今岁八月初三日乃[E1]八旬之庆，又因亲友全来，恐筵宴排设不开，便早同贾赦及贾珍[E2]等商议，议定于七月二十八日起至八月初五日止荣宁两处齐开筵宴，宁国府中单请官客，荣国府中单请堂客，大观园中收拾出缀锦阁并嘉荫堂等几处大地方来作退居	无关系
因今岁八月初三日乃[E1]八旬之庆，又因亲友全来，恐筵宴排设不开，便早同贾赦及[E2]贾琏等商议，议定于七月二十八日起至八月初五日止荣宁两处齐开筵宴，宁国府中单请官客，荣国府中单请堂客，大观园中收拾出缀锦阁并嘉荫堂等几处大地方来作退居	无关系
因今岁八月初三日乃贾母八旬之庆，又因亲友全来，恐筵宴排设不开，便早同贾赦及[E1][E2]等商议，议定于七月二十八日起至八月初五日止荣宁两处齐开筵宴，宁国府中单请官客，荣国府中单请堂客，大观园中收拾出缀锦阁并嘉荫堂等几处大地方来作退居	无关系
初一日是[E2]的家宴，初二日是[E1]，初三日是贾珍贾琏，初四日是贾府中合族长幼大小共凑的家宴	兄弟
初一日是[E2]的家宴，初二日是贾政，初三日是贾珍[E1]，初四日是贾府中合族长幼大小共凑的家宴	儿子
初一日是[E1]的家宴，初二日是贾政，初三日是贾珍[E2]，初四日是贾府中合族长幼大小共凑的家宴	父亲
初一日是贾赦的家宴，初二日是[E1]，初三日是贾珍[E2]，初四日是贾府中合族长幼大小共凑的家宴	无关系
初一日是贾赦的家宴，初二日是[E1]，初三日是[E2]贾琏，初四日是贾府中合族长幼大小共凑的家宴	无关系
初一日是[E1]的家宴，初二日是贾政，初三日是[E2]贾琏，初四日是贾府中合族长幼大小共凑的家宴	无关系
[E1]王夫人带领尤氏凤姐并族中几个媳妇，两溜雁翅站在[E2]身后侍立	大儿媳
[E2]王夫人带领尤氏凤姐并族中几个媳妇，两溜雁翅站在[E1]身后侍立	婆婆
邢夫人[E1]带领尤氏凤姐并族中几个媳妇，两溜雁翅站在[E2]身后侍立	小儿媳
邢夫人王夫人带领[E1]凤姐并族中几个媳妇，两溜雁翅站在[E2]身后侍立	无关系
[E1]王夫人带领[E2]凤姐并族中几个媳妇，两溜雁翅站在贾母身后侍立	无关系
[E1][E2]带领尤氏凤姐并族中几个媳妇，两溜雁翅站在贾母身后侍立	无关系
[E2]劳乏了一日，次日便不会人，一应都是[E1]王夫人管待	大儿媳
[E1]劳乏了一日，次日便不会人，一应都是[E2]王夫人管待	婆婆
[E2]劳乏了一日，次日便不会人，一应都是邢夫人[E1]管待	小儿媳
贾母劳乏了一日，次日便不会人，一应都是[E1][E2]管待	无关系
有那些世家子弟拜寿的，只到厅上行礼，[E2]、[E1]、贾珍等还礼管待，至宁府坐席	兄弟
有那些世家子弟拜寿的，只到厅上行礼，[E1]、贾政、[E2]等还礼管待，至宁府坐席	无关系
[E1]虽不管事，因他素日仗着是[E2]的陪房，原有些体面，心性乖滑，专管各处献勤讨好，所以各处房里的主人都喜欢他	陪房
这费婆子原是[E1]的陪房，起先也曾兴过时，只因[E2]近来不大作兴[E1]，所以连这边的人也减了威势	大儿媳
这费婆子原是[E2]的陪房，起先也曾兴过时，只因[E1]近来不大作兴[E2]，所以连这边的人也减了威势	婆婆
”邢夫人自为要[E1]之后讨了没意思，后来见[E2]越发冷淡了他，凤姐的体面反胜自己，且前日南安太妃来了，要见他姊妹，[E2]又只令探春出来，迎春竟似有如无，自己心内早已怨忿不乐，只是使不出来	丫头
”[E1]自为要鸳鸯之后讨了没意思，后来见[E2]越发冷淡了他，凤姐的体面反胜自己，且前日南安太妃来了，要见他姊妹，[E2]又只令探春出来，迎春竟似有如无，自己心内早已怨忿不乐，只是使不出来	大儿媳
”[E2]自为要鸳鸯之后讨了没意思，后来见[E1]越发冷淡了他，凤姐的体面反胜自己，且前日南安太妃来了，要见他姊妹，[E1]又只令探春出来，迎春竟似有如无，自己心内早已怨忿不乐，只是使不出来	婆婆
”[E1]自为要[E2]之后讨了没意思，后来见贾母越发冷淡了他，凤姐的体面反胜自己，且前日南安太妃来了，要见他姊妹，贾母又只令探春出来，迎春竟似有如无，自己心内早已怨忿不乐，只是使不出来	无关系
[E1]忽过来向凤姐儿面上只管瞧，引的[E2]问说：“你不认得他	丫头
”[E2]因问为什么原故，[E1]便将原故说了	丫头
”一语未了，忽有[E2]那边的小丫头子忙忙走来找[E1]，说：“老太太找姐姐半日，我们那里没找到，却在这里	丫头
”[E1]听说，忙的且去见[E2]	丫头
[E1]素日深与彩霞契合，巴不得与了[E2]，方有个膀臂，不承望王夫人又放了出去	母亲
[E2]素日深与彩霞契合，巴不得与了[E1]，方有个膀臂，不承望王夫人又放了出去	儿子
赵姨娘素日深与[E1]契合，巴不得与了贾环，方有个膀臂，不承望[E2]又放了出去	大丫头
赵姨娘素日深与[E1]契合，巴不得与了[E2]，方有个膀臂，不承望王夫人又放了出去	无关系
[E1]素日深与[E2]契合，巴不得与了贾环，方有个膀臂，不承望王夫人又放了出去	无关系
[E1]素日深与彩霞契合，巴不得与了贾环，方有个膀臂，不承望[E2]又放了出去	无关系
无奈[E1]又不舍，又见他妹子来问，是晚得空，便先求了[E2]	妾
话说那[E1]和[E2]说话，忽听外面一声响，不知何物	妾
[E1]骂了丫头几句，自己带领丫鬟上好，方进来打发[E2]安歇	妾
”当下[E1]并尤氏等都过来请安，凤姐及李纨姊妹等皆陪侍，听[E2]如此说，都默无所答	大儿媳
”当下[E2]并尤氏等都过来请安，凤姐及李纨姊妹等皆陪侍，听[E1]如此说，都默无所答	婆婆
”当下[E1]并[E2]等都过来请安，凤姐及李纨姊妹等皆陪侍，听贾母如此说，都默无所答	无关系
”当下邢夫人并[E1]等都过来请安，凤姐及李纨姊妹等皆陪侍，听[E2]如此说，都默无所答	无关系
刚至园门前，只见[E2]房内的小丫头子名唤[E1]的笑嘻嘻走来，手内拿着个花红柳绿的东西，低头一壁瞧着，一壁只管走，不防迎头撞见邢夫人，抬头看见，方才站住	丫头
刚至园门前，只见[E2]房内的小丫头子名唤傻大姐的笑嘻嘻走来，手内拿着个花红柳绿的东西，低头一壁瞧着，一壁只管走，不防迎头撞见[E1]，抬头看见，方才站住	大儿媳
刚至园门前，只见[E1]房内的小丫头子名唤傻大姐的笑嘻嘻走来，手内拿着个花红柳绿的东西，低头一壁瞧着，一壁只管走，不防迎头撞见[E2]，抬头看见，方才站住	婆婆
拿来我瞧瞧，原来这[E1]年方十四五岁，是新挑上来的与[E2]这边提水桶扫院子专作粗活的丫头	丫头
”左右猜解不来，正要拿去与[E2]看，是以笑嘻嘻的一壁看，一壁走，忽见了[E1]如此说，便笑道：“太太真个说的巧，真个是狗不识呢	大儿媳
”左右猜解不来，正要拿去与[E1]看，是以笑嘻嘻的一壁看，一壁走，忽见了[E2]如此说，便笑道：“太太真个说的巧，真个是狗不识呢	婆婆
王夫人正嫌人少不能勘察，忽见[E2]的陪房[E1]走来，方才正是他送香囊来的	陪房
[E1]正嫌人少不能勘察，忽见邢夫人的陪房[E2]走来，方才正是他送香囊来的	无关系
”凤姐见王夫人盛怒之际，又因[E1]是[E2]的耳目，常调唆着[E2]生事，纵有千百样言词，此刻也不敢说，只低头答应着	陪房
”凤姐见[E1]盛怒之际，又因[E2]是邢夫人的耳目，常调唆着邢夫人生事，纵有千百样言词，此刻也不敢说，只低头答应着	无关系
[E2]歪在榻上，[E1]说甄家因何获罪，如今抄没了家产，回京治罪等语	小儿媳
”尤氏答应，待[E2]漱口洗手毕，[E2]便下地和[E1]说闲话行食	小儿媳
”[E1]答应，待贾母漱口洗手毕，贾母便下地和[E2]说闲话行食	无关系
”[E2]笑道：“[E1]琥珀来趁势也吃些，又作了陪客	丫头
一时[E1]也去用饭，这里尤氏直陪[E2]说话取笑	小儿媳
一时[E1]也去用饭，这里[E2]直陪贾母说话取笑	无关系
[E1]不肯出名，便命[E2]作局家	父亲
[E2]不肯出名，便命[E1]作局家	儿子
不到半月工夫，[E2][E1]听见这般，不知就里，反说这才是正理，文既误矣，武事当亦该习，况在武荫之属	兄弟
于是各不能催，先摆下一大桌，[E1]陪着吃，命[E2]落后陪那一起	父亲
于是各不能催，先摆下一大桌，[E2]陪着吃，命[E1]落后陪那一起	儿子
至四更时，[E2]方散，往[E1]房里去了	妾
[E2]吩咐[E1]道：“你请你奶奶看着送罢，我还有别的事呢	妾
[E2]因要行令，[E1]便叫佩凤等四个人也都入席，下面一溜坐下，猜枚划拳，饮了一回	妻
[E2]因要行令，尤氏便叫[E1]等四个人也都入席，下面一溜坐下，猜枚划拳，饮了一回	妾
[E1]因要行令，[E2]便叫佩凤等四个人也都入席，下面一溜坐下，猜枚划拳，饮了一回	丈夫
贾珍因要行令，[E1]便叫[E2]等四个人也都入席，下面一溜坐下，猜枚划拳，饮了一回	无关系
[E2]有了几分酒，益发高兴，便命取了一竿紫竹箫来，命[E1]吹箫，文花唱曲，喉清嗓嫩，真令人魄醉魂飞	妾
只见[E1]贾政都在[E2]房内坐着说闲话，与[E2]取笑	儿子
只见[E2][E1]都在贾母房内坐着说闲话，与贾母取笑	兄弟
只见贾赦[E1]都在[E2]房内坐着说闲话，与[E2]取笑	儿子
只见[E2]贾政都在[E1]房内坐着说闲话，与[E1]取笑	母亲
”于是[E2][E1]等在前导引，又是两个老婆子秉着两把羊角手罩，鸳鸯、琥珀、尤氏等贴身搀扶，邢夫人等在后围随，从下逶迤而上，不过百余步，至山之峰脊上，便是这座敞厅	兄弟
”于是[E2]贾政等在前导引，又是两个老婆子秉着两把羊角手罩，鸳鸯、琥珀、尤氏等贴身搀扶，[E1]等在后围随，从下逶迤而上，不过百余步，至山之峰脊上，便是这座敞厅	妻
”于是[E1]贾政等在前导引，又是两个老婆子秉着两把羊角手罩，鸳鸯、琥珀、尤氏等贴身搀扶，[E2]等在后围随，从下逶迤而上，不过百余步，至山之峰脊上，便是这座敞厅	丈夫
”于是贾赦贾政等在前导引，又是两个老婆子秉着两把羊角手罩，[E1]、琥珀、尤氏等贴身搀扶，[E2]等在后围随，从下逶迤而上，不过百余步，至山之峰脊上，便是这座敞厅	无关系
”于是贾赦[E1]等在前导引，又是两个老婆子秉着两把羊角手罩，[E2]、琥珀、尤氏等贴身搀扶，邢夫人等在后围随，从下逶迤而上，不过百余步，至山之峰脊上，便是这座敞厅	无关系
”于是贾赦[E1]等在前导引，又是两个老婆子秉着两把羊角手罩，鸳鸯、琥珀、[E2]等贴身搀扶，邢夫人等在后围随，从下逶迤而上，不过百余步，至山之峰脊上，便是这座敞厅	无关系
上面居中贾母坐下，左垂首贾赦、贾珍、贾琏、贾蓉，右垂首[E2]、宝玉、[E1]、贾兰，团团围坐	儿子
上面居中贾母坐下，左垂首贾赦、[E1]、贾琏、[E2]，右垂首贾政、宝玉、贾环、贾兰，团团围坐	父亲
上面居中贾母坐下，左垂首贾赦、贾珍、贾琏、贾蓉，右垂首[E1]、宝玉、[E2]、贾兰，团团围坐	父亲
上面居中贾母坐下，左垂首[E2]、贾珍、[E1]、贾蓉，右垂首贾政、宝玉、贾环、贾兰，团团围坐	儿子
上面居中[E1]坐下，左垂首[E2]、贾珍、贾琏、贾蓉，右垂首贾政、宝玉、贾环、贾兰，团团围坐	母亲
上面居中[E2]坐下，左垂首贾赦、贾珍、贾琏、贾蓉，右垂首[E1]、宝玉、贾环、贾兰，团团围坐	儿子
上面居中贾母坐下，左垂首[E1]、贾珍、[E2]、贾蓉，右垂首贾政、宝玉、贾环、贾兰，团团围坐	父亲
上面居中贾母坐下，左垂首[E2]、贾珍、贾琏、贾蓉，右垂首[E1]、宝玉、贾环、贾兰，团团围坐	兄弟
上面居中[E2]坐下，左垂首[E1]、贾珍、贾琏、贾蓉，右垂首贾政、宝玉、贾环、贾兰，团团围坐	儿子
上面居中贾母坐下，左垂首贾赦、[E2]、贾琏、[E1]，右垂首贾政、宝玉、贾环、贾兰，团团围坐	儿子
上面居中贾母坐下，左垂首[E1]、贾珍、贾琏、[E2]，右垂首贾政、宝玉、贾环、贾兰，团团围坐	无关系
上面居中[E1]坐下，左垂首贾赦、贾珍、[E2]、贾蓉，右垂首贾政、宝玉、贾环、贾兰，团团围坐	无关系
上面居中[E1]坐下，左垂首贾赦、[E2]、贾琏、贾蓉，右垂首贾政、宝玉、贾环、贾兰，团团围坐	无关系
上面居中[E1]坐下，左垂首贾赦、贾珍、贾琏、贾蓉，右垂首贾政、宝玉、[E2]、贾兰，团团围坐	无关系
上面居中贾母坐下，左垂首贾赦、[E1]、[E2]、贾蓉，右垂首贾政、宝玉、贾环、贾兰，团团围坐	无关系
上面居中贾母坐下，左垂首贾赦、[E1]、贾琏、贾蓉，右垂首贾政、宝玉、[E2]、贾兰，团团围坐	无关系
上面居中[E1]坐下，左垂首贾赦、贾珍、贾琏、贾蓉，右垂首贾政、宝玉、贾环、[E2]，团团围坐	无关系
上面居中贾母坐下，左垂首[E1]、[E2]、贾琏、贾蓉，右垂首贾政、宝玉、贾环、贾兰，团团围坐	无关系
上面居中贾母坐下，左垂首贾赦、[E1]、贾琏、贾蓉，右垂首贾政、宝玉、贾环、[E2]，团团围坐	无关系
上面居中贾母坐下，左垂首[E1]、贾珍、贾琏、贾蓉，右垂首贾政、宝玉、[E2]、贾兰，团团围坐	无关系
于是先从[E2]起，次[E1]，一一接过	儿子
于是先从[E1]起，次[E2]，一一接过	母亲
[E1]见[E2]喜悦，只得承欢	儿子
[E1]忙斟了一杯，送与[E2]	儿子
”[E1]因欲[E2]喜悦，便说：“难为他	儿子
[E1]看了喜不自胜，遂并讲与[E2]听时，[E2]也十分欢喜，也忙令[E1]赏他	儿子
”[E1]听说，便知自己出言冒撞，[E2]疑心，忙起身笑与[E2]把盏，以别言解释	儿子
”[E2]听说，便知自己出言冒撞，[E1]疑心，忙起身笑与[E1]把盏，以别言解释	母亲
话说[E2][E1]带领贾珍等散去不提	兄弟
话说[E1]贾政带领[E2]等散去不提	无关系
”[E2]听说，忙命两个婆子快看去，又命[E1]快去	大儿媳
”[E1]听说，忙命两个婆子快看去，又命[E2]快去	婆婆
这里[E1]和翠缕便往[E2]处来	丫头
”[E1]没法，只得亲身过来请问[E2]	小儿媳
[E2]忙命[E1]取出当日所余的来，竟还有一大包，皆有手指头粗细的，遂称二两与王夫人	丫头
[E2]忙命鸳鸯取出当日所余的来，竟还有一大包，皆有手指头粗细的，遂称二两与[E1]	小儿媳
贾母忙命[E1]取出当日所余的来，竟还有一大包，皆有手指头粗细的，遂称二两与[E2]	无关系
[E2]出来交与[E1]拿去令小厮送与医生家去，又命将那几包不能辨得的药也带了去，命医生认了，各包记号了来	陪房
[E1]是已和凤姐等人商议停妥，一字不隐，遂回明[E2]	陪房
话说两个尼姑领了芳官等去后，[E1]便往[E2]处来省晨，见[E2]喜欢，便趁便回道：“宝玉屋里有个晴雯，那个丫头也大了，而且一年之间，病不离身，我常见他比别人分外淘气，也懒，前日又病倒了十几天，叫大夫瞧，说是女儿痨，所以我就赶着叫他下去了	小儿媳
话说两个尼姑领了[E1]等去后，[E2]便往贾母处来省晨，见贾母喜欢，便趁便回道：“宝玉屋里有个晴雯，那个丫头也大了，而且一年之间，病不离身，我常见他比别人分外淘气，也懒，前日又病倒了十几天，叫大夫瞧，说是女儿痨，所以我就赶着叫他下去了	无关系
王夫人又回今日[E1]如何夸奖，又如何带他们逛去，[E2]听了，更加喜悦	儿子
[E2]又回今日[E1]如何夸奖，又如何带他们逛去，贾母听了，更加喜悦	丈夫
[E1]又回今日贾政如何夸奖，又如何带他们逛去，[E2]听了，更加喜悦	小儿媳
[E1]又回今日[E2]如何夸奖，又如何带他们逛去，贾母听了，更加喜悦	妻
[E2]歇晌后，[E1]便唤了凤姐，问他丸药可曾配来	小儿媳
”[E1]又问在席何人，作何诗词等语毕，只将宝玉一分令人拿着，同宝玉兰环前来见过[E2]	小儿媳
[E1]又深恶孙家，虽是世交，当年不过是彼祖希慕荣宁之势，有不能了结之事才拜在门下的，并非诗礼名族之裔，因此倒劝谏过两次，无奈[E2]不听，也只得罢了	兄弟
只听见说娶亲的日子甚急，不过今年就要过门的，又见[E1]等回了[E2]将迎春接出大观园去等事，越发扫去了兴头，每日痴痴呆呆的，不知作何消遣	大儿媳
只听见说娶亲的日子甚急，不过今年就要过门的，又见[E2]等回了[E1]将迎春接出大观园去等事，越发扫去了兴头，每日痴痴呆呆的，不知作何消遣	婆婆
虽百般设法，无奈[E2][E1]执意不从，也只得罢了	小儿媳
今日出了阁，自为要作当家的奶奶，比不得作女儿时腼腆温柔，须要拿出这威风来，才钤压得住人，况且见[E2]气质刚硬，举止骄奢，若不趁热灶一气炮制熟烂，将来必不能自竖旗帜矣，又见有[E1]这等一个才貌俱全的爱妾在室，越发添了“宋太祖灭南唐”之意，“卧榻之侧岂容他人酣睡”之心	妾
先时不过挟制[E1]，后来倚娇作媚，将及[E2]，又将至薛宝钗	儿子
先时不过挟制薛蟠，后来倚娇作媚，将及[E2]，又将至[E1]	女儿
先时不过挟制[E2]，后来倚娇作媚，将及[E1]，又将至薛宝钗	母亲
先时不过挟制[E1]，后来倚娇作媚，将及薛姨妈，又将至[E2]	无关系
那[E2]自为是过了明路的，除了金桂，无人可怕，所以连门也不掩，今见[E1]撞来，故也略有些惭愧，还不十分在意	妾
无奈宝蟾素日最是说嘴要强的，今遇见了[E1]，便恨无地缝儿可入，忙推开[E2]，一径跑了，口内还恨怨不迭，说他强奸力逼等语	妾
无奈[E1]素日最是说嘴要强的，今遇见了香菱，便恨无地缝儿可入，忙推开[E2]，一径跑了，口内还恨怨不迭，说他强奸力逼等语	无关系
[E2]好容易圈哄的要上手，却被[E1]打散，不免一腔兴头变作了一腔恶怒，都在[E1]身上，不容分说，赶出来啐了两口，骂道：“死娼妇，你这会子作什么来撞尸游魂	妾
[E2]再来找宝蟾，已无踪迹了，于是恨的只骂[E1]	妾
薛蟠再来找[E1]，已无踪迹了，于是恨的只骂[E2]	无关系
彼时金桂已暗和宝蟾说明，今夜令[E2]和宝蟾在[E1]房中去成亲，命[E1]过来陪自己先睡	妾
彼时金桂已暗和[E1]说明，今夜令[E2]和[E1]在香菱房中去成亲，命香菱过来陪自己先睡	无关系
”[E2]听了这话，又怕闹黄了宝蟾之事，忙又赶来骂[E1]：“不识抬举	妾
”薛蟠听了这话，又怕闹黄了[E1]之事，忙又赶来骂[E2]：“不识抬举	无关系
[E2]先忙手忙脚的，[E1]自然更乱起来，立刻要拷打众人	儿子
[E1]先忙手忙脚的，[E2]自然更乱起来，立刻要拷打众人	母亲
”[E2]道：“[E1]如今是天天跟着你，他自然知道，先拷问他就知道了	妾
[E2]更被这一席话激怒，顺手抓起一根门闩来，一径抢步找着[E1]，不容分说便劈头劈面打起来，一口咬定是[E1]所施	妾
当下[E2]早被[E1]劝进去了，只命人来卖香菱	女儿
当下[E1]早被薛宝钗劝进去了，只命人来卖[E2]	无关系
宝蟾却不比[E1]的情性，最是个烈火干柴，既和[E2]情投意合，便把金桂忘在脑后	妾
[E1]却不比香菱的情性，最是个烈火干柴，既和[E2]情投意合，便把金桂忘在脑后	无关系
先辞过[E2]及[E1]，然后与众姊妹分别，更皆悲伤不舍	小儿媳
还是[E2][E1]等安慰劝释，方止住了过那边去	姐妹
还是[E1][E2]等安慰劝释，方止住了过那边去	姐妹
宝玉走到[E2]房中，只见[E1]陪着[E2]摸牌	小儿媳
”[E2]告诉[E1]道：“这个样儿也就差不多了	小儿媳
说着凤姐也进来了，见了[E2]，又回身见过了[E1]，说道：“老祖宗要问我什么	小儿媳
”正说着，只见[E1]走来对[E2]道：“老爷要找一件什么东西，请太太伺候了老太太的饭完了自己去找一找呢	丫头
”宝玉连忙答应几个“是”，退出来，忙忙又去见[E1]，又到[E2]那边打了个照面儿	小儿媳
素来看着[E2][E1]光景及凤姐儿往往露出话来，自然是黛玉无疑了	小儿媳
”说着，撞在怀里痛哭，听见[E2]道：“[E1]，你来送姑娘出去歇歇	丫头
[E2]便向[E1]道：“你告诉他们，明儿大夫来瞧了宝玉，就叫他到林姑娘那屋里去	丫头
这里[E1]凤姐等一面遣人拿了方子回[E2]，一面使人到潇湘馆告诉说大夫就过来	小儿媳
”[E1]急忙过来，见了[E2]	儿子
”[E2]急忙过来，见了[E1]	父亲
[E2][E1]迎至二门外，先请了娘娘的安，一面同着进来，走至厅上让了坐	兄弟
”[E1][E2]等站着听了旨意，复又坐下，让老公吃茶毕，老公辞了出去	兄弟
[E1]贾政送出大门，回来先禀[E2]	儿子
[E2][E1]送出大门，回来先禀贾母	兄弟
贾赦[E1]送出大门，回来先禀[E2]	儿子
[E2]贾政送出大门，回来先禀[E1]	母亲
”[E2][E1]答应了出来，因派了贾琏贾蓉看家外，凡文字辈至草字辈一应都去	兄弟
”[E2]贾政答应了出来，因派了[E1]贾蓉看家外，凡文字辈至草字辈一应都去	儿子
”[E1]贾政答应了出来，因派了[E2]贾蓉看家外，凡文字辈至草字辈一应都去	父亲
”贾赦[E1]答应了出来，因派了[E2]贾蓉看家外，凡文字辈至草字辈一应都去	无关系
”[E1]贾政答应了出来，因派了贾琏[E2]看家外，凡文字辈至草字辈一应都去	无关系
”贾赦贾政答应了出来，因派了[E1][E2]看家外，凡文字辈至草字辈一应都去	无关系
[E2][E1]又进去回明老太太，辰巳时进去，申酉时出来，今日早些歇歇，明日好早些起来收拾进宫	兄弟
”不一时，[E2][E1]也过来了	妻
”不一时，[E1][E2]也过来了	丈夫
”[E2][E1]便捱次立定	兄弟
元妃看时，就是[E2][E1]等若干人	兄弟
[E2]等依旧坐着轿子出来，[E1]接着，大伙儿一齐回去	儿子
[E1]等依旧坐着轿子出来，[E2]接着，大伙儿一齐回去	母亲
且说薛家[E2]赶了薛蟠出去，日间拌嘴没有对头，秋菱又住在宝钗那边去了，只剩得[E1]一人同住	陪房丫头
且说薛家[E1]赶了[E2]出去，日间拌嘴没有对头，秋菱又住在宝钗那边去了，只剩得宝蟾一人同住	妻
且说薛家夏金桂赶了薛蟠出去，日间拌嘴没有对头，[E1]又住在宝钗那边去了，只剩得[E2]一人同住	无关系
且说薛家夏金桂赶了[E1]出去，日间拌嘴没有对头，秋菱又住在宝钗那边去了，只剩得[E2]一人同住	无关系
[E1]贾政等禀明了[E2]，一齐谢恩毕，太监吃了茶去了	儿子
[E2][E1]等禀明了贾母，一齐谢恩毕，太监吃了茶去了	兄弟
贾赦[E1]等禀明了[E2]，一齐谢恩毕，太监吃了茶去了	儿子
[E2]贾政等禀明了[E1]，一齐谢恩毕，太监吃了茶去了	母亲
”[E2]便向[E1]道：“你去罢	儿子
”[E1]便向[E2]道：“你去罢	母亲
这里[E2]忽然想起，和[E1]笑道：“娘娘心里却甚实惦记着宝玉，前儿还特特的问他来着呢	儿子
”[E1]及邢王二夫人都答应着，伺侯摆上饭来，[E2]又催了一遍，才都退出各散	儿子
[E1]同[E2]进入房中	丈夫
[E2]同[E1]进入房中	妻
[E1]因提起[E2]方才的话来，说道：“老太太这样疼宝玉，毕竟要他有些实学，日后可以混得功名，才好不枉老太太疼他一场，也不至遭踏了人家的女儿	儿子
”[E1]便告辞，同着[E2]出来，往凤姐院里去了	姐妹
”[E2]便告辞，同着[E1]出来，往凤姐院里去了	姐妹
谁知[E2]陪了[E1]到凤姐那边看巧姐儿去了	姐妹
谁知[E1]陪了[E2]到凤姐那边看巧姐儿去了	姐妹
谁知王夫人陪了[E1]到凤姐那边看[E2]儿去了	无关系
谁知[E1]陪了薛姨妈到凤姐那边看[E2]儿去了	无关系
那天已经掌灯时候，[E1]去了，[E2]才过来了	姐妹
那天已经掌灯时候，[E2]去了，[E1]才过来了	姐妹
却说次日[E1]过[E2]这边来请安，王夫人便提起张家的事，一面回[E2]，一面问[E1]	大儿媳
却说次日[E2]过[E1]这边来请安，王夫人便提起张家的事，一面回[E1]，一面问[E2]	婆婆
却说次日邢夫人过[E2]这边来请安，[E1]便提起张家的事，一面回[E2]，一面问邢夫人	小儿媳
却说次日[E1]过贾母这边来请安，[E2]便提起张家的事，一面回贾母，一面问[E1]	无关系
”[E2]因向[E1]道：“你回来告诉你老爷，就说我的话，这张家的亲事是作不得的	小儿媳
”[E2]忽然想起张家的事来，向[E1]道：“你该就去告诉你老爷，省得人家去说了回来又驳回	小儿媳
”这里[E1]正说着，只听[E2]在外间屋子里更说出些惊心动魄的话来	母亲
”这里[E2]正说着，只听[E1]在外间屋子里更说出些惊心动魄的话来	儿子
话说[E1]正在屋里抱怨[E2]，只听[E2]在外间屋里发话道：“我不过弄倒了药铞子，洒了一点子药，那丫头子又没就死了，值的他也骂我，你也骂我，赖我心坏，把我往死里糟踏	母亲
话说[E2]正在屋里抱怨[E1]，只听[E1]在外间屋里发话道：“我不过弄倒了药铞子，洒了一点子药，那丫头子又没就死了，值的他也骂我，你也骂我，赖我心坏，把我往死里糟踏	儿子
不一时，[E2]过来同[E1]商议，带了贾珍、贾琏、宝玉去与北静王拜寿	兄弟
不一时，[E2]过来同贾政商议，带了贾珍、[E1]、宝玉去与北静王拜寿	儿子
不一时，[E1]过来同贾政商议，带了贾珍、[E2]、宝玉去与北静王拜寿	父亲
不一时，贾赦过来同[E1]商议，带了贾珍、[E2]、宝玉去与北静王拜寿	无关系
不一时，贾赦过来同[E1]商议，带了[E2]、贾琏、宝玉去与北静王拜寿	无关系
不一时，[E1]过来同贾政商议，带了[E2]、贾琏、宝玉去与北静王拜寿	无关系
[E2][E1]递了职名候谕	兄弟
不多时，里面出来了一个太监，手里掐着数珠儿，见了[E2][E1]，笑嘻嘻的说道：“二位老爷好	兄弟
”[E2][E1]也都赶忙问好	兄弟
[E2][E1]先上来请安，捱次便是珍，琏，宝玉请安	兄弟
先是[E2]请北静王受礼，北静王也说了两句谦辞，那[E2]早已跪下，次及[E1]等捱次行礼，自不必说	兄弟
这里[E1]带着他三人回来见过[E2]，请过了安，说了一回府里遇见的人	儿子
饭后，那[E1]谢恩回来，给宗祠里磕了头，便来给[E2]磕头，站着说了几句话，便出去拜客去了	儿子
上首[E1]一桌，是[E2]宝琴陪着，对面老太太一桌，是邢夫人岫烟陪着，下面尚空两桌，贾母叫他们快来，一回儿，只见凤姐领着众丫头，都簇拥着林黛玉来了	姐妹
上首薛姨妈一桌，是王夫人宝琴陪着，对面老太太一桌，是[E1]岫烟陪着，下面尚空两桌，[E2]叫他们快来，一回儿，只见凤姐领着众丫头，都簇拥着林黛玉来了	大儿媳
上首薛姨妈一桌，是[E1]宝琴陪着，对面老太太一桌，是邢夫人岫烟陪着，下面尚空两桌，[E2]叫他们快来，一回儿，只见凤姐领着众丫头，都簇拥着林黛玉来了	小儿媳
上首薛姨妈一桌，是王夫人宝琴陪着，对面老太太一桌，是邢夫人岫烟陪着，下面尚空两桌，[E2]叫他们快来，一回儿，只见凤姐领着众丫头，都簇拥着[E1]来了	外孙女
上首[E2]一桌，是[E1]宝琴陪着，对面老太太一桌，是邢夫人岫烟陪着，下面尚空两桌，贾母叫他们快来，一回儿，只见凤姐领着众丫头，都簇拥着林黛玉来了	姐妹
上首薛姨妈一桌，是王夫人宝琴陪着，对面老太太一桌，是[E2]岫烟陪着，下面尚空两桌，[E1]叫他们快来，一回儿，只见凤姐领着众丫头，都簇拥着林黛玉来了	婆婆
上首薛姨妈一桌，是王夫人宝琴陪着，对面老太太一桌，是邢夫人岫烟陪着，下面尚空两桌，[E1]叫他们快来，一回儿，只见凤姐领着众丫头，都簇拥着[E2]来了	外祖母
上首薛姨妈一桌，是王夫人宝琴陪着，对面老太太一桌，是[E1]岫烟陪着，下面尚空两桌，贾母叫他们快来，一回儿，只见凤姐领着众丫头，都簇拥着[E2]来了	无关系
上首[E1]一桌，是王夫人宝琴陪着，对面老太太一桌，是邢夫人岫烟陪着，下面尚空两桌，[E2]叫他们快来，一回儿，只见凤姐领着众丫头，都簇拥着林黛玉来了	无关系
上首薛姨妈一桌，是[E1]宝琴陪着，对面老太太一桌，是[E2]岫烟陪着，下面尚空两桌，贾母叫他们快来，一回儿，只见凤姐领着众丫头，都簇拥着林黛玉来了	无关系
上首薛姨妈一桌，是[E1]宝琴陪着，对面老太太一桌，是邢夫人岫烟陪着，下面尚空两桌，贾母叫他们快来，一回儿，只见凤姐领着众丫头，都簇拥着[E2]来了	无关系
上首[E1]一桌，是王夫人宝琴陪着，对面老太太一桌，是邢夫人岫烟陪着，下面尚空两桌，贾母叫他们快来，一回儿，只见凤姐领着众丫头，都簇拥着[E2]来了	无关系
上首[E1]一桌，是王夫人宝琴陪着，对面老太太一桌，是[E2]岫烟陪着，下面尚空两桌，贾母叫他们快来，一回儿，只见凤姐领着众丫头，都簇拥着林黛玉来了	无关系
话说[E2]听了[E1]的来书，因叫进小厮问道：“你听见你大爷说，到底是怎么就把人打死了呢	侄儿
这里[E1]自来见[E2]，托[E2]转求贾政	姐妹
这里[E2]自来见[E1]，托[E1]转求贾政	姐妹
这里薛姨妈自来见[E2]，托[E2]转求[E1]	丈夫
这里薛姨妈自来见[E1]，托[E1]转求[E2]	妻
这里[E1]自来见王夫人，托王夫人转求[E2]	无关系
[E1]听了，叫小厮自去，即刻又到贾府与[E2]说明原故，恳求贾政	姐妹
[E2]听了，叫小厮自去，即刻又到贾府与[E1]说明原故，恳求贾政	姐妹
薛姨妈听了，叫小厮自去，即刻又到贾府与[E2]说明原故，恳求[E1]	丈夫
薛姨妈听了，叫小厮自去，即刻又到贾府与[E1]说明原故，恳求[E2]	妻
[E1]听了，叫小厮自去，即刻又到贾府与王夫人说明原故，恳求[E2]	无关系
[E1]留下李祥在此照料，一径回家，见了[E2]，陈说知县怎样徇情，怎样审断，终定了误伤，将来尸亲那里再花些银子，一准赎罪，便没事了	侄儿
见了[E2]，也顾不得问好，便问[E1]的事	儿子
见了[E1]，也顾不得问好，便问[E2]的事	母亲
宝玉回到自己房中，换了衣服，忽然想起[E1]给的汗巾，便向[E2]道：“你那一年没有系的那条红汗巾子还有没有	夫妻
”宝玉听了，方回身到[E2][E1]处去禀明了，然后回到怡红院中	儿子
[E1]遂辞了出来，同小丫头来至[E2]房中，回了一遍	丫头
看见[E2]与李纨打双陆，[E1]旁边瞧着	丫头
”因看着[E1]，又想起[E2]来，“这也不枉你大哥哥死了，你大嫂子拉扯他一场，日后也替你大哥哥顶门壮户	妻
”因看着[E2]，又想起[E1]来，“这也不枉你大哥哥死了，你大嫂子拉扯他一场，日后也替你大哥哥顶门壮户	丈夫
”琥珀接着便叫人去[E2]那边请[E1]	姐妹
”琥珀接着便叫人去[E1]那边请[E2]	姐妹
[E2]尚等着伺候贾母的晚饭，[E1]便跟着他母亲站着	儿子
李纨尚等着伺候[E1]的晚饭，[E2]便跟着他母亲站着	无关系
那秋桐本来不顺凤姐，后来[E2]因[E1]之事不大爱惜他了，凤姐又笼络他，如今倒也安静，只是心里比平儿差多了，外面情儿	二房
那[E1]本来不顺凤姐，后来贾琏因[E2]之事不大爱惜他了，凤姐又笼络他，如今倒也安静，只是心里比平儿差多了，外面情儿	无关系
况且明知[E1]事忙，[E2]溺爱，便点点头儿	儿子
宝玉一径回来，见过[E2][E1]，也是这样说，自然没有不信的，略坐一坐便回园中去了	小儿媳
那黛玉虽有[E2][E1]等怜恤，不过请医调治，只说黛玉常病，那里知他的心病	小儿媳
[E2]等见他这病不似无因而起，也将[E1]雪雁盘问过两次，两个那里敢说	丫头
[E1]等见他这病不似无因而起，也将紫鹃[E2]盘问过两次，两个那里敢说	无关系
恰好[E2]、[E1]、李纨、凤姐听见紫鹃之言，都赶着来看	小儿媳
恰好[E2]、王夫人、李纨、凤姐听见[E1]之言，都赶着来看	丫头
恰好贾母、[E1]、李纨、凤姐听见[E2]之言，都赶着来看	无关系
”[E2]听了[E1]的话，不觉又伤心起来，说道：“我虽有儿，如今就象没有的了，就是上司准了，也是个废人	侄儿
[E2]回到自己房中，吃了晚饭，想起[E1]住在贾府园中，终是寄人篱下，况且又穷，日用起居，不想可知	妻
[E2]十分欢喜，想到必是[E1]娶这媳妇时冲犯了什么，才败坏了这几年	儿子
[E1]十分欢喜，想到必是[E2]娶这媳妇时冲犯了什么，才败坏了这几年	母亲
男在县里也不受苦，母亲放心	儿子
男在县里也不受苦，母亲放心	母亲
”[E2]没法，只得叫[E1]到县照料，命人即便收拾行李，兑了银子，家人李祥本在那里照应的，[E1]又同了一个当中伙计连夜起程	侄儿
那时[E1]又有信回来，[E2]看了，怕宝钗耽忧，也不叫他知道	侄儿
[E1]去后，[E2]又求贾政	姐妹
[E2]去后，[E1]又求贾政	姐妹
薛姨妈去后，[E2]又求[E1]	丈夫
薛姨妈去后，[E1]又求[E2]	妻
[E1]去后，王夫人又求[E2]	无关系
到了明日，[E2]将贾政的话向[E1]述了	姐妹
到了明日，[E1]将贾政的话向[E2]述了	姐妹
到了明日，[E2]将[E1]的话向薛姨妈述了	丈夫
到了明日，[E1]将[E2]的话向薛姨妈述了	妻
到了明日，王夫人将[E1]的话向[E2]述了	无关系
到了饭后，[E1]陪着来到[E2]房中，大家让了坐	小儿媳
”王夫人便把[E1]昨夜所说的话向[E2]述了一遍，[E2]甚喜	儿子
”[E2]便把[E1]昨夜所说的话向贾母述了一遍，贾母甚喜	丈夫
”[E1]便把贾政昨夜所说的话向[E2]述了一遍，[E2]甚喜	小儿媳
”[E1]便把[E2]昨夜所说的话向贾母述了一遍，贾母甚喜	妻
到了次日，果然一早到老太太那里请了安，又到[E1]王夫人那里请了安，回明了老太太今儿不叫上学，[E1]也没言语，便慢慢退出来，走了几步便一溜烟跑到[E2]房中	儿子
到了次日，果然一早到老太太那里请了安，又到[E1][E2]那里请了安，回明了老太太今儿不叫上学，[E1]也没言语，便慢慢退出来，走了几步便一溜烟跑到贾母房中	丈夫
到了次日，果然一早到老太太那里请了安，又到贾政[E1]那里请了安，回明了老太太今儿不叫上学，贾政也没言语，便慢慢退出来，走了几步便一溜烟跑到[E2]房中	小儿媳
到了次日，果然一早到老太太那里请了安，又到[E2][E1]那里请了安，回明了老太太今儿不叫上学，[E2]也没言语，便慢慢退出来，走了几步便一溜烟跑到贾母房中	妻
后来又在[E1]家看[E2]去，五儿跟着他妈给[E2]送东西去，见了一面，更觉娇娜妩媚	姑舅哥哥
回来李纨同着他妹子、探春、惜春、[E1]、黛玉都来了，大家请了[E2]的安	孙女
[E2][E1]道：“你说什么	兄弟
”[E2][E1]便命贾琏送了出去	兄弟
”[E2]贾政便命[E1]送了出去	儿子
”[E1]贾政便命[E2]送了出去	父亲
”贾赦[E1]便命[E2]送了出去	无关系
[E1]也不往下问，竟与[E2]各自说了一回话儿散了	兄弟
[E1]告诉[E2]道：“我是衙门里有事，琏儿要在家等候拿车的事情，也不能去，倒是大老爷带宝玉应酬一天也罢了	兄弟
到了家中，[E2]自回那边去了，宝玉来见[E1]	兄弟
话说赖大带了贾芹出来，一宿无话，静候[E1]回来	儿子
话说[E1]带了贾芹出来，一宿无话，静候[E2]回来	无关系
且说紫鹃因黛玉渐好，园中无事，听见女尼等预备宫内使唤，不知何事，便到[E2]那边打听打听，恰遇着[E1]下来，闲着坐下说闲话儿，提起女尼的事	丫头
且说[E1]因黛玉渐好，园中无事，听见女尼等预备宫内使唤，不知何事，便到[E2]那边打听打听，恰遇着鸳鸯下来，闲着坐下说闲话儿，提起女尼的事	丫头
且说[E1]因黛玉渐好，园中无事，听见女尼等预备宫内使唤，不知何事，便到贾母那边打听打听，恰遇着[E2]下来，闲着坐下说闲话儿，提起女尼的事	无关系
”正说着，只见傅试家两个女人过来请[E2]的安，[E1]要陪了上去	丫头
那两个女人因[E2]正睡晌觉，就与[E1]说了一声儿回去了	丫头
”[E2][E1]听了喜欢，便说：“林姑娘比方得有理，很有意思	小儿媳
正说着，贾赦、[E1]、[E2]、贾兰都进来看花	父亲
正说着，[E2]、[E1]、贾环、贾兰都进来看花	兄弟
正说着，贾赦、[E2]、[E1]、贾兰都进来看花	儿子
正说着，贾赦、贾政、[E1]、[E2]都进来看花	无关系
正说着，[E1]、贾政、贾环、[E2]都进来看花	无关系
正说着，[E1]、贾政、[E2]、贾兰都进来看花	无关系
”[E1]听了，不敢言语，讪讪的同[E2]等走了出来	兄弟
烟凝媚色春前萎，霜浥微红雪后开	儿子
还是李纨探春从实的告诉了王夫人一遍，王夫人也急得泪如雨下，索性要回明[E2]，去问[E1]那边跟来的这些人去	大儿媳
还是李纨探春从实的告诉了王夫人一遍，王夫人也急得泪如雨下，索性要回明[E1]，去问[E2]那边跟来的这些人去	婆婆
还是李纨探春从实的告诉了[E1]一遍，[E1]也急得泪如雨下，索性要回明[E2]，去问邢夫人那边跟来的这些人去	小儿媳
还是李纨探春从实的告诉了[E1]一遍，[E1]也急得泪如雨下，索性要回明贾母，去问[E2]那边跟来的这些人去	无关系
[E1]收了泪，去请[E2]，只说元妃有病，进去请安	小儿媳
[E2][E1]遵旨进宫，见元妃痰塞口涎，不能言语，见了[E2]，只有悲泣之状，却少眼泪	小儿媳
[E2][E1]怎忍便离，无奈国家制度，只得下来，又不敢啼哭，惟有心内悲感	小儿媳
到家中，[E1]、李纨、凤姐、宝玉等出厅分东西迎着[E2]请了安，并贾政王夫人请安，大家哭泣	大儿媳
到家中，邢夫人、李纨、凤姐、宝玉等出厅分东西迎着贾母请了安，并[E1][E2]请安，大家哭泣	丈夫
到家中，邢夫人、李纨、凤姐、宝玉等出厅分东西迎着[E2]请了安，并贾政[E1]请安，大家哭泣	小儿媳
到家中，邢夫人、李纨、凤姐、宝玉等出厅分东西迎着[E2]请了安，并[E1]王夫人请安，大家哭泣	儿子
到家中，[E2]、李纨、凤姐、宝玉等出厅分东西迎着[E1]请了安，并贾政王夫人请安，大家哭泣	婆婆
到家中，邢夫人、李纨、凤姐、宝玉等出厅分东西迎着贾母请了安，并[E2][E1]请安，大家哭泣	妻
到家中，[E1]、李纨、凤姐、宝玉等出厅分东西迎着贾母请了安，并贾政[E2]请安，大家哭泣	无关系
到家中，[E1]、李纨、凤姐、宝玉等出厅分东西迎着贾母请了安，并[E2]王夫人请安，大家哭泣	无关系
”[E1]知[E2]生气，叫袭人等跪下，自己敛容低首回说：“媳妇恐老太太着急老爷生气，都没敢回	小儿媳
”[E1]知贾母生气，叫[E2]等跪下，自己敛容低首回说：“媳妇恐老太太着急老爷生气，都没敢回	无关系
[E1]见了这般光景，未免落泪，在[E2]这里，不敢出声	小儿媳
[E2]知[E1]着急，便说道：“你回去罢，这里有我调停他	小儿媳
”王夫人去后，[E2]叫[E1]找些安神定魄的药，按方吃了	丫头
”[E1]去后，[E2]叫鸳鸯找些安神定魄的药，按方吃了	小儿媳
”[E1]去后，贾母叫[E2]找些安神定魄的药，按方吃了	无关系
[E1]知是老太太的主意，又不敢违拗，只抱怨[E2]几句	丈夫
[E2]知是老太太的主意，又不敢违拗，只抱怨[E1]几句	妻
那日[E1][E2]出门，只有贾琏在家	兄弟
那日贾政[E2]出门，只有[E1]在家	儿子
那日贾政[E1]出门，只有[E2]在家	父亲
那日[E1]贾赦出门，只有[E2]在家	无关系
”贾琏却也喜欢，忙去禀知[E1]，即便回明[E2]	小儿媳
”[E1]却也喜欢，忙去禀知[E2]，即便回明贾母	无关系
贾琏看了，喜之不胜，便叫家人伺候，忙忙的送与[E2][E1]认去	小儿媳
[E1]看了，喜之不胜，便叫家人伺候，忙忙的送与[E2]王夫人认去	无关系
”[E2]听了，一阵心酸，便心口疼得坐不住，叫[E1]等扶了上炕，还扎挣着叫贾琏去回了贾政，“即速收拾行装迎到那里，帮着料理完毕，既刻回来告诉我们	大丫头
”[E2]听了，一阵心酸，便心口疼得坐不住，叫彩云等扶了上炕，还扎挣着叫贾琏去回了[E1]，“即速收拾行装迎到那里，帮着料理完毕，既刻回来告诉我们	丈夫
”[E1]听了，一阵心酸，便心口疼得坐不住，叫彩云等扶了上炕，还扎挣着叫贾琏去回了[E2]，“即速收拾行装迎到那里，帮着料理完毕，既刻回来告诉我们	妻
”[E1]听了，一阵心酸，便心口疼得坐不住，叫彩云等扶了上炕，还扎挣着叫[E2]去回了贾政，“即速收拾行装迎到那里，帮着料理完毕，既刻回来告诉我们	无关系
”王夫人听了，一阵心酸，便心口疼得坐不住，叫彩云等扶了上炕，还扎挣着叫[E1]去回了[E2]，“即速收拾行装迎到那里，帮着料理完毕，既刻回来告诉我们	无关系
”王夫人听了，一阵心酸，便心口疼得坐不住，叫[E1]等扶了上炕，还扎挣着叫贾琏去回了[E2]，“即速收拾行装迎到那里，帮着料理完毕，既刻回来告诉我们	无关系
[E1]早已知道，心里很不受用，又知宝玉失玉以后神志惛愦，医药无效，又值[E2]心疼	丈夫
[E2]早已知道，心里很不受用，又知宝玉失玉以后神志惛愦，医药无效，又值[E1]心疼	妻
[E1]即忙进去，看见[E2]带着病也在那里	丈夫
[E2]即忙进去，看见[E1]带着病也在那里	妻
”[E2]见[E1]说着也有些眼圈儿红，知道心里是疼的，便叫袭人扶了宝玉来	丈夫
”[E1]见[E2]说着也有些眼圈儿红，知道心里是疼的，便叫袭人扶了宝玉来	妻
”王夫人见[E1]说着也有些眼圈儿红，知道心里是疼的，便叫[E2]扶了宝玉来	无关系
”[E1]见贾政说着也有些眼圈儿红，知道心里是疼的，便叫[E2]扶了宝玉来	无关系
”[E1]听了，原不愿意，只是[E2]做主，不敢违命，勉强陪笑说道：“老太太想的极是，也很妥当	儿子
因赴任事多，部里领凭，亲友们荐人，种种应酬不绝，竟把宝玉的事，听凭[E2]交与[E1]凤姐儿了	小儿媳
[E2]定了主意叫人告诉他去，[E1]只说很好，此是后话	儿子
[E2]与[E1]所说的话，宝玉一句也没有听见	儿子
”袭人想定主意，待等[E1]出去，叫秋纹照看着宝玉，便从里间出来，走到王夫人身旁，悄悄的请了王夫人到[E2]后身屋里去说话	儿子
”袭人想定主意，待等[E1]出去，叫秋纹照看着宝玉，便从里间出来，走到[E2]身旁，悄悄的请了[E2]到贾母后身屋里去说话	丈夫
”袭人想定主意，待等贾政出去，叫秋纹照看着宝玉，便从里间出来，走到[E1]身旁，悄悄的请了[E1]到[E2]后身屋里去说话	小儿媳
”袭人想定主意，待等[E2]出去，叫秋纹照看着宝玉，便从里间出来，走到[E1]身旁，悄悄的请了[E1]到贾母后身屋里去说话	妻
”袭人想定主意，待等[E1]出去，叫[E2]照看着宝玉，便从里间出来，走到王夫人身旁，悄悄的请了王夫人到贾母后身屋里去说话	无关系
”[E1]想定主意，待等贾政出去，叫秋纹照看着宝玉，便从里间出来，走到王夫人身旁，悄悄的请了王夫人到[E2]后身屋里去说话	无关系
”[E1]想定主意，待等贾政出去，叫[E2]照看着宝玉，便从里间出来，走到王夫人身旁，悄悄的请了王夫人到贾母后身屋里去说话	无关系
”袭人想定主意，待等贾政出去，叫[E1]照看着宝玉，便从里间出来，走到[E2]身旁，悄悄的请了[E2]到贾母后身屋里去说话	无关系
[E2]正在那里和凤姐儿商议，见[E1]进来，便问道：“袭人丫头说什么	小儿媳
贾母正在那里和凤姐儿商议，见[E1]进来，便问道：“[E2]丫头说什么	无关系
”[E1]趁问，便将宝玉的心事，细细回明[E2]	小儿媳
”[E1]恐[E2]问及，使个眼色与凤姐	小儿媳
一日，黛玉早饭后带着[E1]到[E2]这边来，一则请安，二则也为自己散散闷	丫头
”[E1]听了，摸不着头脑，只得搀着他到[E2]这边来	丫头
黛玉走到[E2]门口，心里微觉明晰，回头看见[E1]搀着自己，便站住了问道：“你作什么来的	丫头
[E2]又问了[E1]一回，到底不知是那个说的	丫头
”[E2][E1]都道：“你说的是	小儿媳
[E2]感激不尽，说些[E1]的话	儿子
[E1]感激不尽，说些[E2]的话	母亲
当晚[E1]果然过来，见过了贾母，到[E2]屋里来，不免说起王子腾来，大家落了一回泪	姐妹
当晚[E2]果然过来，见过了贾母，到[E1]屋里来，不免说起王子腾来，大家落了一回泪	姐妹
当晚薛姨妈果然过来，见过了[E2]，到[E1]屋里来，不免说起王子腾来，大家落了一回泪	小儿媳
当晚薛姨妈果然过来，见过了贾母，到[E1]屋里来，不免说起[E2]来，大家落了一回泪	无关系
当晚[E1]果然过来，见过了[E2]，到王夫人屋里来，不免说起王子腾来，大家落了一回泪	无关系
当晚[E1]果然过来，见过了贾母，到王夫人屋里来，不免说起[E2]来，大家落了一回泪	无关系
”[E2]便按着凤姐的话和[E1]说，只说：“姨太太这会子家里没人，不如把装奁一概蠲免	姐妹
”[E1]便按着凤姐的话和[E2]说，只说：“姨太太这会子家里没人，不如把装奁一概蠲免	姐妹
”正说着，只见[E2]差[E1]过来候信	丫头
[E2]也甚喜欢，又叫[E1]过来求薛姨妈和宝钗说明原故，不叫他受委屈	丫头
贾母也甚喜欢，又叫[E1]过来求[E2]和宝钗说明原故，不叫他受委屈	无关系
[E2]才告诉了[E1]，叫他明日起身，“一则打听审详的事，二则告诉你哥哥一个信儿，你即便回来	侄儿
[E1]去了四日，便回来回复[E2]道：“哥哥的事上司已经准了误杀，一过堂就要题本了，叫咱们预备赎罪的银子	侄儿
’”[E2]听了，一则[E1]可以回家，二则完了宝钗的事，心里安放了好些	儿子
’”[E1]听了，一则[E2]可以回家，二则完了宝钗的事，心里安放了好些	母亲
这里[E1]叫了凤姐命人将过礼的物件都送与[E2]过目，并叫袭人告诉宝玉	小儿媳
这里[E1]叫了凤姐命人将过礼的物件都送与贾母过目，并叫[E2]告诉宝玉	无关系
”[E2][E1]听了，都喜欢道：“说他糊涂，他今日怎么这么明白呢	小儿媳
”[E1]等忍不住好笑，只得上来一件一件的点明给[E2]瞧，说：“这是金项圈，这是金珠首饰，共八十件	丫头
[E1]等看去，只有一息奄奄，明知劝不过来，惟有守着流泪，天天三四趟去告诉[E2]	丫头
[E1]测度[E2]近日比前疼黛玉的心差了些，所以不常去回	丫头
[E1]看着不祥了，连忙将雪雁等都叫进来看守，自己却来回[E2]	丫头
[E1]看着不祥了，连忙将[E2]等都叫进来看守，自己却来回贾母	无关系
[E2]正在那里给[E1]改诗，冒冒失失的见一个丫头进来回说：“大奶奶，只怕林姑娘好不了，那里都哭呢	儿子
请出[E2]受了四拜，后请[E1]夫妇登堂，行礼毕，送入洞房	儿子
[E1]原为[E2]作主，不敢违拗，不信冲喜之说	儿子
那知今日宝玉居然象个好人一般，[E1]见了，倒也喜欢，那新人坐了床便要揭起盖头的，凤姐早已防备，故请[E2]王夫人等进去照应	儿子
那知今日宝玉居然象个好人一般，[E1]见了，倒也喜欢，那新人坐了床便要揭起盖头的，凤姐早已防备，故请贾母[E2]等进去照应	丈夫
那知今日宝玉居然象个好人一般，贾政见了，倒也喜欢，那新人坐了床便要揭起盖头的，凤姐早已防备，故请[E2][E1]等进去照应	小儿媳
那知今日宝玉居然象个好人一般，[E2]见了，倒也喜欢，那新人坐了床便要揭起盖头的，凤姐早已防备，故请贾母[E1]等进去照应	妻
宝玉定了一回神，见[E2][E1]坐在那边，便轻轻的叫袭人道：“我是在那里呢	小儿媳
宝玉定了一回神，见贾母[E1]坐在那边，便轻轻的叫[E2]道：“我是在那里呢	无关系
次早，[E1]辞了宗祠，过来拜别[E2]，禀称：“不孝远离，惟愿老太太顺时颐养	儿子
”[E2]恐[E1]在路不放心，并不将宝玉复病的话说起，只说：“我有一句话，宝玉昨夜完姻，并不是同房	儿子
”[E2]听了，又放了一条心，便叫[E1]坐着，叫鸳鸯去如此如此，带了宝玉，叫袭人跟着来	儿子
”[E2]听了，又放了一条心，便叫贾政坐着，叫[E1]去如此如此，带了宝玉，叫袭人跟着来	丫头
”贾母听了，又放了一条心，便叫[E1]坐着，叫[E2]去如此如此，带了宝玉，叫袭人跟着来	无关系
”贾母听了，又放了一条心，便叫[E1]坐着，叫鸳鸯去如此如此，带了宝玉，叫[E2]跟着来	无关系
[E1]叫人扶他回去了，自己回到[E2]房中，又切实的叫[E2]管教儿子，断不可如前娇纵	丈夫
[E2]叫人扶他回去了，自己回到[E1]房中，又切实的叫[E1]管教儿子，断不可如前娇纵	妻
贾母[E2]等才放了心，请了[E1]带了宝钗都到贾母那里暂且歇息	姐妹
贾母[E1]等才放了心，请了[E2]带了宝钗都到贾母那里暂且歇息	姐妹
[E2][E1]等才放了心，请了薛姨妈带了宝钗都到[E2]那里暂且歇息	小儿媳
[E1]王夫人等才放了心，请了[E2]带了宝钗都到[E1]那里暂且歇息	无关系
回首看时，不是别人，正是[E2]、[E1]、宝钗、袭人等围绕哭泣叫着	小儿媳
回首看时，不是别人，正是贾母、[E1]、宝钗、[E2]等围绕哭泣叫着	无关系
[E2][E1]等不知宝钗的用意，深怪他造次	小儿媳
宝钗看来不妨大事，于是自己心也安了，只在[E2][E1]等前尽行过家庭之礼后，便设法以释宝玉之忧	小儿媳
那宝玉心里虽不顺遂，无奈日里贾母[E2]及[E1]等轮流相伴，夜间宝钗独去安寝，贾母又派人服侍，只得安心静养	姐妹
那宝玉心里虽不顺遂，无奈日里贾母[E1]及[E2]等轮流相伴，夜间宝钗独去安寝，贾母又派人服侍，只得安心静养	姐妹
那宝玉心里虽不顺遂，无奈日里[E2][E1]及薛姨妈等轮流相伴，夜间宝钗独去安寝，[E2]又派人服侍，只得安心静养	小儿媳
那宝玉心里虽不顺遂，无奈日里[E1]王夫人及[E2]等轮流相伴，夜间宝钗独去安寝，[E1]又派人服侍，只得安心静养	无关系
凤姐因见[E2]王夫人等忙乱，[E1]起身，又为宝玉昏愦更甚，正在着急异常之时，若是又将黛玉的凶信一回，恐[E2]王夫人愁苦交加，急出病来，只得亲自到园	儿子
凤姐因见贾母[E2]等忙乱，[E1]起身，又为宝玉昏愦更甚，正在着急异常之时，若是又将黛玉的凶信一回，恐贾母[E2]愁苦交加，急出病来，只得亲自到园	丈夫
凤姐因见[E2][E1]等忙乱，贾政起身，又为宝玉昏愦更甚，正在着急异常之时，若是又将黛玉的凶信一回，恐[E2][E1]愁苦交加，急出病来，只得亲自到园	小儿媳
凤姐因见贾母[E1]等忙乱，[E2]起身，又为宝玉昏愦更甚，正在着急异常之时，若是又将黛玉的凶信一回，恐贾母[E1]愁苦交加，急出病来，只得亲自到园	妻
凤姐到了宝玉那里，听见大夫说不妨事，[E2][E1]略觉放心，凤姐便背了宝玉，缓缓的将黛玉的事回明了	小儿媳
[E2][E1]听得都唬了一大跳	小儿媳
[E1]等含悲共劝[E2]不必过去，”老太太身子要紧	小儿媳
”[E2]无奈，只得叫[E1]自去	小儿媳
走至半路，正遇[E1]过来，一一回明了[E2]	小儿媳
李纨便请[E2][E1]在里间歇着，犹自落泪	小儿媳
紫鹃本来深恨宝玉，见如此，心里已回过来些，又见[E2][E1]都在这里，不敢洒落宝玉，便将林姑娘怎么复病，怎么烧毁帕子，焚化诗稿，并将临死说的话，一一的都告诉了	小儿媳
[E1]本来深恨宝玉，见如此，心里已回过来些，又见[E2]王夫人都在这里，不敢洒落宝玉，便将林姑娘怎么复病，怎么烧毁帕子，焚化诗稿，并将临死说的话，一一的都告诉了	丫头
[E1]本来深恨宝玉，见如此，心里已回过来些，又见贾母[E2]都在这里，不敢洒落宝玉，便将林姑娘怎么复病，怎么烧毁帕子，焚化诗稿，并将临死说的话，一一的都告诉了	无关系
[E2]更加心痛难禁，也便回去，派了[E1]帮着袭人照应，并说：“宝玉若再悲戚，速来告诉我们	大丫头
[E1]更加心痛难禁，也便回去，派了彩云帮着[E2]照应，并说：“宝玉若再悲戚，速来告诉我们	无关系
[E2]幸不成病，惟是[E1]心痛未痊	小儿媳
况且亲戚姊妹们，薛宝琴已回到薛姨妈那边去了，史湘云因史侯回京，也接了家去了，又有了出嫁的日子，所以不大常来，只有宝玉娶亲那一日与吃喜酒这天来过两次，也只在[E2]那边住下，为着宝玉已经娶过亲的人，又想自己就要出嫁的，也不肯如从前的诙谐谈笑，就是有时过来，也只和宝钗说话，见了宝玉不过问好而已，那邢岫烟却是因迎春出嫁之后便随着[E1]过去，李家姊妹也另住在外，即同着李婶娘过来，亦不过到太太们与姐妹们处请安问好，即回到李纨那里略住一两天就去了：所以园内的只有李纨、探春、惜春了	大儿媳
况且亲戚姊妹们，[E2]已回到[E1]那边去了，史湘云因史侯回京，也接了家去了，又有了出嫁的日子，所以不大常来，只有宝玉娶亲那一日与吃喜酒这天来过两次，也只在贾母那边住下，为着宝玉已经娶过亲的人，又想自己就要出嫁的，也不肯如从前的诙谐谈笑，就是有时过来，也只和宝钗说话，见了宝玉不过问好而已，那邢岫烟却是因迎春出嫁之后便随着邢夫人过去，李家姊妹也另住在外，即同着李婶娘过来，亦不过到太太们与姐妹们处请安问好，即回到李纨那里略住一两天就去了：所以园内的只有李纨、探春、惜春了	姑母
况且亲戚姊妹们，[E1]已回到[E2]那边去了，史湘云因史侯回京，也接了家去了，又有了出嫁的日子，所以不大常来，只有宝玉娶亲那一日与吃喜酒这天来过两次，也只在贾母那边住下，为着宝玉已经娶过亲的人，又想自己就要出嫁的，也不肯如从前的诙谐谈笑，就是有时过来，也只和宝钗说话，见了宝玉不过问好而已，那邢岫烟却是因迎春出嫁之后便随着邢夫人过去，李家姊妹也另住在外，即同着李婶娘过来，亦不过到太太们与姐妹们处请安问好，即回到李纨那里略住一两天就去了：所以园内的只有李纨、探春、惜春了	侄女
况且亲戚姊妹们，薛宝琴已回到薛姨妈那边去了，史湘云因史侯回京，也接了家去了，又有了出嫁的日子，所以不大常来，只有宝玉娶亲那一日与吃喜酒这天来过两次，也只在贾母那边住下，为着宝玉已经娶过亲的人，又想自己就要出嫁的，也不肯如从前的诙谐谈笑，就是有时过来，也只和宝钗说话，见了宝玉不过问好而已，那[E1]却是因迎春出嫁之后便随着[E2]过去，李家姊妹也另住在外，即同着李婶娘过来，亦不过到太太们与姐妹们处请安问好，即回到李纨那里略住一两天就去了：所以园内的只有李纨、探春、惜春了	侄女
况且亲戚姊妹们，薛宝琴已回到薛姨妈那边去了，史湘云因史侯回京，也接了家去了，又有了出嫁的日子，所以不大常来，只有宝玉娶亲那一日与吃喜酒这天来过两次，也只在[E1]那边住下，为着宝玉已经娶过亲的人，又想自己就要出嫁的，也不肯如从前的诙谐谈笑，就是有时过来，也只和宝钗说话，见了宝玉不过问好而已，那邢岫烟却是因迎春出嫁之后便随着[E2]过去，李家姊妹也另住在外，即同着李婶娘过来，亦不过到太太们与姐妹们处请安问好，即回到李纨那里略住一两天就去了：所以园内的只有李纨、探春、惜春了	婆婆
况且亲戚姊妹们，薛宝琴已回到薛姨妈那边去了，[E1]因史侯回京，也接了家去了，又有了出嫁的日子，所以不大常来，只有宝玉娶亲那一日与吃喜酒这天来过两次，也只在[E2]那边住下，为着宝玉已经娶过亲的人，又想自己就要出嫁的，也不肯如从前的诙谐谈笑，就是有时过来，也只和宝钗说话，见了宝玉不过问好而已，那邢岫烟却是因迎春出嫁之后便随着邢夫人过去，李家姊妹也另住在外，即同着李婶娘过来，亦不过到太太们与姐妹们处请安问好，即回到李纨那里略住一两天就去了：所以园内的只有李纨、探春、惜春了	孙女
况且亲戚姊妹们，[E1]已回到薛姨妈那边去了，[E2]因史侯回京，也接了家去了，又有了出嫁的日子，所以不大常来，只有宝玉娶亲那一日与吃喜酒这天来过两次，也只在贾母那边住下，为着宝玉已经娶过亲的人，又想自己就要出嫁的，也不肯如从前的诙谐谈笑，就是有时过来，也只和宝钗说话，见了宝玉不过问好而已，那邢岫烟却是因迎春出嫁之后便随着邢夫人过去，李家姊妹也另住在外，即同着李婶娘过来，亦不过到太太们与姐妹们处请安问好，即回到李纨那里略住一两天就去了：所以园内的只有李纨、探春、惜春了	无关系
况且亲戚姊妹们，薛宝琴已回到薛姨妈那边去了，[E1]因史侯回京，也接了家去了，又有了出嫁的日子，所以不大常来，只有宝玉娶亲那一日与吃喜酒这天来过两次，也只在贾母那边住下，为着宝玉已经娶过亲的人，又想自己就要出嫁的，也不肯如从前的诙谐谈笑，就是有时过来，也只和宝钗说话，见了宝玉不过问好而已，那邢岫烟却是因迎春出嫁之后便随着[E2]过去，李家姊妹也另住在外，即同着李婶娘过来，亦不过到太太们与姐妹们处请安问好，即回到李纨那里略住一两天就去了：所以园内的只有李纨、探春、惜春了	无关系
况且亲戚姊妹们，[E1]已回到薛姨妈那边去了，史湘云因史侯回京，也接了家去了，又有了出嫁的日子，所以不大常来，只有宝玉娶亲那一日与吃喜酒这天来过两次，也只在贾母那边住下，为着宝玉已经娶过亲的人，又想自己就要出嫁的，也不肯如从前的诙谐谈笑，就是有时过来，也只和宝钗说话，见了宝玉不过问好而已，那[E2]却是因迎春出嫁之后便随着邢夫人过去，李家姊妹也另住在外，即同着李婶娘过来，亦不过到太太们与姐妹们处请安问好，即回到李纨那里略住一两天就去了：所以园内的只有李纨、探春、惜春了	无关系
况且亲戚姊妹们，薛宝琴已回到[E1]那边去了，[E2]因史侯回京，也接了家去了，又有了出嫁的日子，所以不大常来，只有宝玉娶亲那一日与吃喜酒这天来过两次，也只在贾母那边住下，为着宝玉已经娶过亲的人，又想自己就要出嫁的，也不肯如从前的诙谐谈笑，就是有时过来，也只和宝钗说话，见了宝玉不过问好而已，那邢岫烟却是因迎春出嫁之后便随着邢夫人过去，李家姊妹也另住在外，即同着李婶娘过来，亦不过到太太们与姐妹们处请安问好，即回到李纨那里略住一两天就去了：所以园内的只有李纨、探春、惜春了	无关系
况且亲戚姊妹们，薛宝琴已回到[E1]那边去了，史湘云因史侯回京，也接了家去了，又有了出嫁的日子，所以不大常来，只有宝玉娶亲那一日与吃喜酒这天来过两次，也只在[E2]那边住下，为着宝玉已经娶过亲的人，又想自己就要出嫁的，也不肯如从前的诙谐谈笑，就是有时过来，也只和宝钗说话，见了宝玉不过问好而已，那邢岫烟却是因迎春出嫁之后便随着邢夫人过去，李家姊妹也另住在外，即同着李婶娘过来，亦不过到太太们与姐妹们处请安问好，即回到李纨那里略住一两天就去了：所以园内的只有李纨、探春、惜春了	无关系
况且亲戚姊妹们，薛宝琴已回到[E1]那边去了，史湘云因史侯回京，也接了家去了，又有了出嫁的日子，所以不大常来，只有宝玉娶亲那一日与吃喜酒这天来过两次，也只在贾母那边住下，为着宝玉已经娶过亲的人，又想自己就要出嫁的，也不肯如从前的诙谐谈笑，就是有时过来，也只和宝钗说话，见了宝玉不过问好而已，那[E2]却是因迎春出嫁之后便随着邢夫人过去，李家姊妹也另住在外，即同着李婶娘过来，亦不过到太太们与姐妹们处请安问好，即回到李纨那里略住一两天就去了：所以园内的只有李纨、探春、惜春了	无关系
[E1]心想薛蟠的事到底有什么挂碍，在外头信息不早，难以打点，故回到本任来便打发家人进京打听，顺便将总制求亲之事回明[E2]，如若愿意，即将三姑娘接到任所	儿子
[E1]心想[E2]的事到底有什么挂碍，在外头信息不早，难以打点，故回到本任来便打发家人进京打听，顺便将总制求亲之事回明贾母，如若愿意，即将三姑娘接到任所	无关系
家人奉命赶到京中，回明了[E2]，便在吏部打听得[E1]并无处分，惟将署太平县的这位老爷革职，即写了禀帖安慰了[E1]，然后住着等信	丈夫
家人奉命赶到京中，回明了[E1]，便在吏部打听得[E2]并无处分，惟将署太平县的这位老爷革职，即写了禀帖安慰了[E2]，然后住着等信	妻
且说[E2]为着[E1]这件人命官司，各衙门内不知花了多少银钱，才定了误杀具题	儿子
且说[E1]为着[E2]这件人命官司，各衙门内不知花了多少银钱，才定了误杀具题	母亲
是日，宝钗在[E2]屋里听得[E1]告诉老太太要聘探春一事	小儿媳
因必要[E1]过来，立即回了[E2]去叫他	丫头
无奈紫鹃心里不愿意，虽经[E2][E1]派了过来，也就没法，只是在宝玉跟前，不是嗳声，就是叹气的	小儿媳
无奈[E1]心里不愿意，虽经[E2]王夫人派了过来，也就没法，只是在宝玉跟前，不是嗳声，就是叹气的	丫头
无奈[E1]心里不愿意，虽经贾母[E2]派了过来，也就没法，只是在宝玉跟前，不是嗳声，就是叹气的	无关系
那雪雁虽是宝玉娶亲这夜出过力的，宝钗见他心地不甚明白，便回了[E2][E1]，将他配了一个小厮，各自过活去了	小儿媳
那[E1]虽是宝玉娶亲这夜出过力的，宝钗见他心地不甚明白，便回了[E2]王夫人，将他配了一个小厮，各自过活去了	无关系
”正说着，[E2]那边打发过[E1]来说，知道宝玉旧病又发，叫袭人劝说安慰，叫他不要胡思乱想	丫头
”正说着，贾母那边打发过[E1]来说，知道宝玉旧病又发，叫[E2]劝说安慰，叫他不要胡思乱想	无关系
凤姐回至家中，见了[E2][E1]等，问起签来，命人一解，都欢喜非常，”或者老爷果有此心，咱们走一趟也好	小儿媳
到了宝玉娶亲，[E2]一死，[E1]回去，宝琴在家住着，园中人少，况兼天气寒冷，李纨姊妹、探春、惜春等俱挪回旧所	朋友
[E1]着急，便叫[E2]来打听外头有好医生再请几位来瞧瞧	父亲
[E2]着急，便叫[E1]来打听外头有好医生再请几位来瞧瞧	儿子
[E2]奉上卦金，送了出去，回禀[E1]，说是：“母亲的病是在旧宅傍晚得的，为撞着什么伏尸白虎	父亲
[E1]奉上卦金，送了出去，回禀[E2]，说是：“母亲的病是在旧宅傍晚得的，为撞着什么伏尸白虎	儿子
[E1]方好，[E2]等相继而病	父亲
[E2]方好，[E1]等相继而病	儿子
却说[E2]的表兄[E1]正住在园门口，他媳妇自从[E2]死后，听见说作了花神，每日晚间便不敢出门	姑舅哥哥
”[E2]未听说完，便叫[E1]：“先去告诉你婶子知道，且不必告诉老太太就是了	儿子
”[E1]未听说完，便叫[E2]：“先去告诉你婶子知道，且不必告诉老太太就是了	父亲
贾琏答应了，才要出来，只见[E1]家的老婆子慌慌张张的走来，到[E2]里间屋内，也没说请安，便道：“我们太太叫我来告诉这里的姨太太，说我们家了不得了，又闹出事来了	姐妹
贾琏答应了，才要出来，只见[E2]家的老婆子慌慌张张的走来，到[E1]里间屋内，也没说请安，便道：“我们太太叫我来告诉这里的姨太太，说我们家了不得了，又闹出事来了	姐妹
[E1]答应了，才要出来，只见薛姨妈家的老婆子慌慌张张的走来，到[E2]里间屋内，也没说请安，便道：“我们太太叫我来告诉这里的姨太太，说我们家了不得了，又闹出事来了	无关系
[E1]答应了，才要出来，只见[E2]家的老婆子慌慌张张的走来，到王夫人里间屋内，也没说请安，便道：“我们太太叫我来告诉这里的姨太太，说我们家了不得了，又闹出事来了	无关系
恰好[E2]打发周瑞家的照看，一进门来，见一个老婆子指着[E1]的脸哭骂	姐妹
恰好[E1]打发周瑞家的照看，一进门来，见一个老婆子指着[E2]的脸哭骂	姐妹
恰好[E2]打发[E1]照看，一进门来，见一个老婆子指着薛姨妈的脸哭骂	陪房
恰好王夫人打发[E1]照看，一进门来，见一个老婆子指着[E2]的脸哭骂	无关系
[E1]迎着，请[E2]的安，然后众子侄俱请了[E1]的安，一同进府	儿子
[E1]先到了[E2]那里拜见了，陈述些违别的话	儿子
”[E2]始则因[E1]降调回来，知探春远在他乡，一无亲故，心下不悦	儿子
[E1]回到自己屋内，[E2]等见过，宝玉贾琏替另拜见	丈夫
[E2]回到自己屋内，[E1]等见过，宝玉贾琏替另拜见	妻
[E1]回到自己屋内，王夫人等见过，宝玉[E2]替另拜见	无关系
贾政回到自己屋内，[E1]等见过，宝玉[E2]替另拜见	无关系
分派已定，[E1]与[E2]说些别后的话，余者[E2]都不敢言	丈夫
分派已定，[E2]与[E1]说些别后的话，余者[E1]都不敢言	妻
倒是[E1]先提起王子腾的事来，[E2]也不敢悲戚	丈夫
倒是[E2]先提起王子腾的事来，[E1]也不敢悲戚	妻
倒是[E1]先提起[E2]的事来，王夫人也不敢悲戚	无关系
倒是贾政先提起[E1]的事来，[E2]也不敢悲戚	无关系
[E1]又说蟠儿的事，[E2]只说他是自作自受，趁便也将黛玉已死的话告诉	丈夫
[E2]又说蟠儿的事，[E1]只说他是自作自受，趁便也将黛玉已死的话告诉	妻
旁边[E1]等即忙拉衣，[E2]止住，重又说些喜欢的话，便安寝了	大丫头
只说宝玉因昨[E1]问起黛玉，[E2]答以有病，他便暗里伤心	丈夫
只说宝玉因昨[E2]问起黛玉，[E1]答以有病，他便暗里伤心	妻
独有[E2][E1]一干人唬得面如土色，满身发颤	兄弟
”维时贾赦、[E2]、贾琏、贾珍、贾蓉、贾蔷、贾芝、贾兰俱在，惟宝玉假说有病，在贾母那边打闹，[E1]本来不大见人的，所以就将现在几人看住	儿子
”维时贾赦、贾政、贾琏、[E1]、[E2]、贾蔷、贾芝、贾兰俱在，惟宝玉假说有病，在贾母那边打闹，贾环本来不大见人的，所以就将现在几人看住	父亲
”维时贾赦、[E1]、贾琏、贾珍、贾蓉、贾蔷、贾芝、贾兰俱在，惟宝玉假说有病，在贾母那边打闹，[E2]本来不大见人的，所以就将现在几人看住	父亲
”维时[E2]、贾政、[E1]、贾珍、贾蓉、贾蔷、贾芝、贾兰俱在，惟宝玉假说有病，在贾母那边打闹，贾环本来不大见人的，所以就将现在几人看住	儿子
”维时贾赦、贾政、贾琏、[E2]、贾蓉、[E1]、贾芝、贾兰俱在，惟宝玉假说有病，在贾母那边打闹，贾环本来不大见人的，所以就将现在几人看住	养子
”维时[E2]、贾政、贾琏、贾珍、贾蓉、贾蔷、贾芝、贾兰俱在，惟宝玉假说有病，在[E1]那边打闹，贾环本来不大见人的，所以就将现在几人看住	母亲
”维时贾赦、[E1]、贾琏、贾珍、贾蓉、贾蔷、贾芝、贾兰俱在，惟宝玉假说有病，在[E2]那边打闹，贾环本来不大见人的，所以就将现在几人看住	儿子
”维时[E1]、贾政、[E2]、贾珍、贾蓉、贾蔷、贾芝、贾兰俱在，惟宝玉假说有病，在贾母那边打闹，贾环本来不大见人的，所以就将现在几人看住	父亲
”维时[E2]、[E1]、贾琏、贾珍、贾蓉、贾蔷、贾芝、贾兰俱在，惟宝玉假说有病，在贾母那边打闹，贾环本来不大见人的，所以就将现在几人看住	兄弟
”维时[E1]、贾政、贾琏、贾珍、贾蓉、贾蔷、贾芝、贾兰俱在，惟宝玉假说有病，在[E2]那边打闹，贾环本来不大见人的，所以就将现在几人看住	儿子
”维时贾赦、贾政、贾琏、[E2]、[E1]、贾蔷、贾芝、贾兰俱在，惟宝玉假说有病，在贾母那边打闹，贾环本来不大见人的，所以就将现在几人看住	儿子
”维时[E1]、贾政、贾琏、贾珍、[E2]、贾蔷、贾芝、贾兰俱在，惟宝玉假说有病，在贾母那边打闹，贾环本来不大见人的，所以就将现在几人看住	无关系
”维时贾赦、贾政、[E1]、贾珍、贾蓉、贾蔷、[E2]、贾兰俱在，惟宝玉假说有病，在贾母那边打闹，贾环本来不大见人的，所以就将现在几人看住	无关系
”维时贾赦、贾政、贾琏、贾珍、贾蓉、[E1]、贾芝、贾兰俱在，惟宝玉假说有病，在[E2]那边打闹，贾环本来不大见人的，所以就将现在几人看住	无关系
”维时贾赦、贾政、贾琏、贾珍、贾蓉、贾蔷、[E1]、[E2]俱在，惟宝玉假说有病，在贾母那边打闹，贾环本来不大见人的，所以就将现在几人看住	无关系
”维时贾赦、贾政、贾琏、贾珍、[E1]、贾蔷、贾芝、贾兰俱在，惟宝玉假说有病，在[E2]那边打闹，贾环本来不大见人的，所以就将现在几人看住	无关系
”维时贾赦、贾政、贾琏、贾珍、贾蓉、贾蔷、贾芝、[E1]俱在，惟宝玉假说有病，在[E2]那边打闹，贾环本来不大见人的，所以就将现在几人看住	无关系
”维时贾赦、贾政、贾琏、贾珍、贾蓉、贾蔷、贾芝、贾兰俱在，惟宝玉假说有病，在[E1]那边打闹，[E2]本来不大见人的，所以就将现在几人看住	无关系
”维时贾赦、[E1]、[E2]、贾珍、贾蓉、贾蔷、贾芝、贾兰俱在，惟宝玉假说有病，在贾母那边打闹，贾环本来不大见人的，所以就将现在几人看住	无关系
”维时贾赦、贾政、贾琏、[E1]、贾蓉、贾蔷、贾芝、贾兰俱在，惟宝玉假说有病，在贾母那边打闹，[E2]本来不大见人的，所以就将现在几人看住	无关系
”维时贾赦、[E1]、贾琏、[E2]、贾蓉、贾蔷、贾芝、贾兰俱在，惟宝玉假说有病，在贾母那边打闹，贾环本来不大见人的，所以就将现在几人看住	无关系
”维时贾赦、[E1]、贾琏、贾珍、贾蓉、[E2]、贾芝、贾兰俱在，惟宝玉假说有病，在贾母那边打闹，贾环本来不大见人的，所以就将现在几人看住	无关系
”赵堂官站起来说：“回王爷：[E2][E1]并未分家，闻得他侄儿贾琏现在承总管家，不能不尽行查抄	兄弟
”赵堂官站起来说：“回王爷：[E2]贾政并未分家，闻得他侄儿[E1]现在承总管家，不能不尽行查抄	儿子
”赵堂官站起来说：“回王爷：[E1]贾政并未分家，闻得他侄儿[E2]现在承总管家，不能不尽行查抄	父亲
”赵堂官站起来说：“回王爷：贾赦[E1]并未分家，闻得他侄儿[E2]现在承总管家，不能不尽行查抄	无关系
赵堂官便说：“[E1][E2]两处须得奴才带领去查抄才好	儿子
赵堂官便说：“[E2][E1]两处须得奴才带领去查抄才好	父亲
且说[E2]那边女眷也摆家宴，[E1]正在那边说：“宝玉不到外头，恐他老子生气	小儿媳
然后贾琏定神将两王恩典说明，惟恐贾母[E2]知道[E1]被拿，又要唬死，暂且不敢明说，只得出来照料自己屋内	丈夫
然后贾琏定神将两王恩典说明，惟恐[E2][E1]知道贾赦被拿，又要唬死，暂且不敢明说，只得出来照料自己屋内	大儿媳
然后[E1]定神将两王恩典说明，惟恐贾母邢夫人知道[E2]被拿，又要唬死，暂且不敢明说，只得出来照料自己屋内	儿子
然后贾琏定神将两王恩典说明，惟恐[E1]邢夫人知道[E2]被拿，又要唬死，暂且不敢明说，只得出来照料自己屋内	母亲
然后贾琏定神将两王恩典说明，惟恐[E1][E2]知道贾赦被拿，又要唬死，暂且不敢明说，只得出来照料自己屋内	婆婆
然后[E2]定神将两王恩典说明，惟恐贾母邢夫人知道[E1]被拿，又要唬死，暂且不敢明说，只得出来照料自己屋内	父亲
然后贾琏定神将两王恩典说明，惟恐[E2]邢夫人知道[E1]被拿，又要唬死，暂且不敢明说，只得出来照料自己屋内	儿子
然后贾琏定神将两王恩典说明，惟恐贾母[E1]知道[E2]被拿，又要唬死，暂且不敢明说，只得出来照料自己屋内	妻
然后[E1]定神将两王恩典说明，惟恐贾母[E2]知道贾赦被拿，又要唬死，暂且不敢明说，只得出来照料自己屋内	无关系
然后[E1]定神将两王恩典说明，惟恐[E2]邢夫人知道贾赦被拿，又要唬死，暂且不敢明说，只得出来照料自己屋内	无关系
[E1]无心查问，一直到[E2]房中，只见人人泪痕满面，王夫人宝玉等围住[E2]，寂静无言，各各掉泪	儿子
[E1]无心查问，一直到贾母房中，只见人人泪痕满面，[E2]宝玉等围住贾母，寂静无言，各各掉泪	丈夫
贾政无心查问，一直到[E2]房中，只见人人泪痕满面，[E1]宝玉等围住[E2]，寂静无言，各各掉泪	小儿媳
[E2]无心查问，一直到贾母房中，只见人人泪痕满面，[E1]宝玉等围住贾母，寂静无言，各各掉泪	妻
”[E2]见[E1]不在，又伤心起来，贾政再三安慰方止	儿子
”贾母见[E2]不在，又伤心起来，[E1]再三安慰方止	兄弟
”[E2]见贾赦不在，又伤心起来，[E1]再三安慰方止	儿子
”[E1]见[E2]不在，又伤心起来，贾政再三安慰方止	母亲
”[E1]也不答言，仍走到[E2]那边	大儿媳
”[E2]也不答言，仍走到[E1]那边	婆婆
话说[E1]闻知[E2]危急，即忙进去看视	儿子
见[E2]惊吓气逆，王夫人[E1]等唤醒回来，即用疏气安神的丸药服了，渐渐的好些，只是伤心落泪	丫头
见[E2]惊吓气逆，[E1]鸳鸯等唤醒回来，即用疏气安神的丸药服了，渐渐的好些，只是伤心落泪	小儿媳
见贾母惊吓气逆，[E1][E2]等唤醒回来，即用疏气安神的丸药服了，渐渐的好些，只是伤心落泪	无关系
承办官遵旨一一查清，入官者入官，给还者给还，将[E1]放出，所有[E2]名下男妇人等造册入官	儿子
承办官遵旨一一查清，入官者入官，给还者给还，将[E2]放出，所有[E1]名下男妇人等造册入官	父亲
承办官遵旨一一查清，[E1]者[E1]，给还者给还，将[E2]放出，所有贾赦名下男妇人等造册[E1]	无关系
承办官遵旨一一查清，[E1]者[E1]，给还者给还，将贾琏放出，所有[E2]名下男妇人等造册[E1]	无关系
那时天已点灯时候，[E1]进去请[E2]的安，见[E2]略略好些	儿子
幸[E2]不知底细，因近日身子好些，又见[E1]无事，宝玉宝钗在旁天天不离左右，略觉放心	儿子
那贾赦[E1][E2]在锦衣府使用，帐房内实在无项可支	父亲
那贾赦[E2][E1]在锦衣府使用，帐房内实在无项可支	儿子
那[E1][E2]贾蓉在锦衣府使用，帐房内实在无项可支	无关系
那[E1]贾珍[E2]在锦衣府使用，帐房内实在无项可支	无关系
且说[E2]见祖宗世职革去，现在子孙在监质审，[E1]尤氏等日夜啼哭，凤姐病在垂危，虽有宝玉宝钗在侧，只可解劝，不能分忧，所以日夜不宁，思前想后，眼泪不干	大儿媳
且说[E1]见祖宗世职革去，现在子孙在监质审，[E2]尤氏等日夜啼哭，凤姐病在垂危，虽有宝玉宝钗在侧，只可解劝，不能分忧，所以日夜不宁，思前想后，眼泪不干	婆婆
且说[E1]见祖宗世职革去，现在子孙在监质审，邢夫人[E2]等日夜啼哭，凤姐病在垂危，虽有宝玉宝钗在侧，只可解劝，不能分忧，所以日夜不宁，思前想后，眼泪不干	无关系
且说贾母见祖宗世职革去，现在子孙在监质审，[E1][E2]等日夜啼哭，凤姐病在垂危，虽有宝玉宝钗在侧，只可解劝，不能分忧，所以日夜不宁，思前想后，眼泪不干	无关系
只见[E1]带了宝玉宝钗过来请晚安，见[E2]悲伤，三人也大哭起来	小儿媳
想到后来终身，更比[E2][E1]哭得更痛	小儿媳
那[E1]正在书房纳闷，听见[E2]的人来报，心中着忙，飞奔进内	儿子
一时[E1]不放心，又进来瞧瞧老太太，见是好些，便出来传了赖大，叫他将合府里管事家人的花名册子拿来，一齐点了一点，除去[E2]入官的人，尚有三十余家，共男女二百十二名	兄弟
一时贾政不放心，又进来瞧瞧老太太，见是好些，便出来传了[E1]，叫他将合府里管事家人的花名册子拿来，一齐点了一点，除去贾赦[E2]的人，尚有三十余家，共男女二百十二名	无关系
话说[E1]进内，见了枢密院各位大人，又见了各位王爷	儿子
只见[E1]忙忙的走到[E2]跟前，将蒙圣恩宽免的事，细细告诉了一遍	儿子
[E2]虽则放心，只是两个世职革去，[E1]又往台站效力，贾珍又往海疆，不免又悲伤起来	儿子
[E1]虽则放心，只是两个世职革去，[E2]又往台站效力，贾珍又往海疆，不免又悲伤起来	母亲
[E1]虽则放心，只是两个世职革去，贾赦又往台站效力，[E2]又往海疆，不免又悲伤起来	无关系
贾母虽则放心，只是两个世职革去，[E1]又往台站效力，[E2]又往海疆，不免又悲伤起来	无关系
[E2]素来本不大喜欢[E1]，那边东府贾珍究竟隔了一层	儿子
[E1]素来本不大喜欢[E2]，那边东府贾珍究竟隔了一层	母亲
[E1]素来本不大喜欢贾赦，那边东府[E2]究竟隔了一层	无关系
贾母素来本不大喜欢[E1]，那边东府[E2]究竟隔了一层	无关系
”那[E1]本来独掌宁府的家计，除了[E2]也算是惟他为尊，又与[E2]夫妇相和，“如今犯事远出，家财抄尽，依往荣府，虽则老太太疼爱，终是依人门下	妻
”那[E2]本来独掌宁府的家计，除了[E1]也算是惟他为尊，又与[E1]夫妇相和，“如今犯事远出，家财抄尽，依往荣府，虽则老太太疼爱，终是依人门下	丈夫
[E2]不忍，便问[E1]道：“你大哥和珍儿现已定案，可能回家	儿子
”[E1]正是没法，听见[E2]一问，心想着：“若是说明，又恐老太太着急，若不说明，不用说将来，现在怎样办法	儿子
”[E2]正在忧虑，只见[E1]、贾珍、贾蓉一齐进来给[E2]请安	儿子
”贾母正在忧虑，只见贾赦、[E1]、[E2]一齐进来给贾母请安	父亲
”贾母正在忧虑，只见贾赦、[E2]、[E1]一齐进来给贾母请安	儿子
”[E1]正在忧虑，只见[E2]、贾珍、贾蓉一齐进来给[E1]请安	母亲
”贾母正在忧虑，只见[E1]、贾珍、[E2]一齐进来给贾母请安	无关系
”[E1]正在忧虑，只见贾赦、贾珍、[E2]一齐进来给[E1]请安	无关系
”贾母正在忧虑，只见[E1]、[E2]、贾蓉一齐进来给贾母请安	无关系
”[E1]正在忧虑，只见贾赦、[E2]、贾蓉一齐进来给[E1]请安	无关系
[E2]看这般光景，一只手拉着[E1]，一只手拉着贾珍，便大哭起来	儿子
[E1]看这般光景，一只手拉着[E2]，一只手拉着贾珍，便大哭起来	母亲
[E1]看这般光景，一只手拉着贾赦，一只手拉着[E2]，便大哭起来	无关系
贾母看这般光景，一只手拉着[E1]，一只手拉着[E2]，便大哭起来	无关系
这里[E2]等出来，又与[E1]哭泣了一会，都不免将从前任性过后恼悔如今分离的话说了一会，各自同媳妇那边悲伤去了	兄弟
贾赦年老，倒也抛的下，独有[E2]与[E1]怎忍分离	妻
贾赦年老，倒也抛的下，独有[E1]与[E2]怎忍分离	丈夫
[E1]年老，倒也抛的下，独有[E2]与尤氏怎忍分离	无关系
[E1]年老，倒也抛的下，独有贾珍与[E2]怎忍分离	无关系
却说[E1]叫邢王二夫人同了鸳鸯等，开箱倒笼，将做媳妇到如今积攒的东西都拿出来，又叫[E2]、贾政、贾珍等，一一的分派说：“这里现有的银子，交[E2]三千两，你拿二千两去做你的盘费使用，留一千给大太太另用	母亲
却说[E2]叫邢王二夫人同了鸳鸯等，开箱倒笼，将做媳妇到如今积攒的东西都拿出来，又叫贾赦、[E1]、贾珍等，一一的分派说：“这里现有的银子，交贾赦三千两，你拿二千两去做你的盘费使用，留一千给大太太另用	儿子
却说[E2]叫邢王二夫人同了[E1]等，开箱倒笼，将做媳妇到如今积攒的东西都拿出来，又叫贾赦、贾政、贾珍等，一一的分派说：“这里现有的银子，交贾赦三千两，你拿二千两去做你的盘费使用，留一千给大太太另用	丫头
却说[E2]叫邢王二夫人同了鸳鸯等，开箱倒笼，将做媳妇到如今积攒的东西都拿出来，又叫[E1]、贾政、贾珍等，一一的分派说：“这里现有的银子，交[E1]三千两，你拿二千两去做你的盘费使用，留一千给大太太另用	儿子
却说贾母叫邢王二夫人同了鸳鸯等，开箱倒笼，将做媳妇到如今积攒的东西都拿出来，又叫[E2]、[E1]、贾珍等，一一的分派说：“这里现有的银子，交[E2]三千两，你拿二千两去做你的盘费使用，留一千给大太太另用	兄弟
却说贾母叫邢王二夫人同了鸳鸯等，开箱倒笼，将做媳妇到如今积攒的东西都拿出来，又叫贾赦、[E1]、[E2]等，一一的分派说：“这里现有的银子，交贾赦三千两，你拿二千两去做你的盘费使用，留一千给大太太另用	无关系
却说贾母叫邢王二夫人同了[E1]等，开箱倒笼，将做媳妇到如今积攒的东西都拿出来，又叫贾赦、[E2]、贾珍等，一一的分派说：“这里现有的银子，交贾赦三千两，你拿二千两去做你的盘费使用，留一千给大太太另用	无关系
却说贾母叫邢王二夫人同了[E1]等，开箱倒笼，将做媳妇到如今积攒的东西都拿出来，又叫贾赦、贾政、[E2]等，一一的分派说：“这里现有的银子，交贾赦三千两，你拿二千两去做你的盘费使用，留一千给大太太另用	无关系
却说贾母叫邢王二夫人同了鸳鸯等，开箱倒笼，将做媳妇到如今积攒的东西都拿出来，又叫[E1]、贾政、[E2]等，一一的分派说：“这里现有的银子，交[E1]三千两，你拿二千两去做你的盘费使用，留一千给大太太另用	无关系
却说[E1]叫邢王二夫人同了鸳鸯等，开箱倒笼，将做媳妇到如今积攒的东西都拿出来，又叫贾赦、贾政、[E2]等，一一的分派说：“这里现有的银子，交贾赦三千两，你拿二千两去做你的盘费使用，留一千给大太太另用	无关系
”[E1]本是不知当家立计的人，一听[E2]的话，一一领命，心想：“老太太实在真真是理家的人，都是我们这些不长进的闹坏了	儿子
”[E1]见[E2]劳乏，求着老太太歇歇养神	儿子
[E2]正自长篇大论的说，只见丰儿慌慌张张的跑来回[E1]道：“今早我们奶奶听见外头的事，哭了一场，如今气都接不上来	小儿媳
这里[E2]才叫[E1]等派人拿了给凤姐的东西跟着过来	丫头
平儿哭得眼红，听见[E2]带着[E1]、宝玉、宝钗过来，疾忙出来迎接	小儿媳
凤姐本是贪得无厌的人，如今被抄尽净，本是愁苦，又恐人埋怨，正是几不欲生的时候，今儿[E2]仍旧疼他，[E1]也没嗔怪，过来安慰他，又想贾琏无事，心下安放好些，便在枕上与[E2]磕头，说道：“请老太太放心	小儿媳
凤姐本是贪得无厌的人，如今被抄尽净，本是愁苦，又恐人埋怨，正是几不欲生的时候，今儿[E1]仍旧疼他，王夫人也没嗔怪，过来安慰他，又想[E2]无事，心下安放好些，便在枕上与[E1]磕头，说道：“请老太太放心	无关系
[E2]实在不忍闻见，便叫[E1]散去，叫宝玉“去见你大爷大哥，送一送就回来	小儿媳
幸喜[E1]等能用百样言语劝解，[E2]暂且安歇	丫头
”正闹着，[E1]回家，门上回了，虽则喜欢，究是哥哥犯事所致，反觉感极涕零，赶着进内告诉[E2]	儿子
[E1]正恐[E2]伤心，过来安慰，听得世职复还，自是欢喜	小儿媳
又见[E1]进来，[E2]拉了说些勤黾报恩的话	儿子
此时[E1]理家，又奉了[E2]之命将人口渐次减少，诸凡省俭，尚且不能支持	儿子
幸喜凤姐为[E2]疼惜，[E1]等虽则不大喜欢，若说治家办事尚能出力，所以将内事仍交凤姐办理	小儿媳
于是[E2]放心，[E1]尤氏也略略宽怀	大儿媳
于是[E1]放心，[E2]尤氏也略略宽怀	婆婆
于是[E1]放心，邢夫人[E2]也略略宽怀	无关系
于是贾母放心，[E1][E2]也略略宽怀	无关系
一日，[E1]出嫁回门，来[E2]这边请安	孙女
[E2]提起他女婿甚好，[E1]也将那里过日平安的话说了，请老太太放心	孙女
[E1]劝解一回，又到各家请安问好毕，仍到[E2]房中安歇，言及“薛家这样人家被薛大哥闹的家破人亡	孙女
[E1]劝解一回，又到各家请安问好毕，仍到贾母房中安歇，言及“薛家这样人家被[E2]哥闹的家破人亡	无关系
[E2]为着“齐全”两字，也想[E1]等，叫人请去	大儿媳
[E1]为着“齐全”两字，也想[E2]等，叫人请去	婆婆
[E2]问起岫烟来，[E1]假说病着不来	大儿媳
[E1]问起岫烟来，[E2]假说病着不来	婆婆
”[E2]侧着耳朵听了，笑道：“若是行令，又得叫[E1]去	丫头
[E2]举酒要喝，[E1]道：“这是姨太太掷的，还该姨太太说个曲牌名儿，下家儿接一句《千家诗》	丫头
[E1]便到[E2]那里住下	姐妹
[E2]便到[E1]那里住下	姐妹
宝钗起来梳洗了，莺儿袭人等跟着先到[E2]那里行了礼，便到[E1]那边起至凤姐都让过了，仍到[E2]处，见他母亲也过来了	小儿媳
宝钗起来梳洗了，莺儿[E1]等跟着先到[E2]那里行了礼，便到王夫人那边起至凤姐都让过了，仍到[E2]处，见他母亲也过来了	无关系
这日晚间，宝玉回到自己屋里，见宝钗自[E2][E1]处才请了晚安回来	小儿媳
这里[E2]因疼宝玉，又想宝钗孝顺，忽然想起一件东西，便叫[E1]开了箱子，取出祖上所遗一个汉玉..，虽不及宝玉他那块玉石，挂在身上却也稀罕	丫头
[E1]找出来递与[E2]，便说道：“这件东西我好象从没见的，老太太这些年还记得这样清楚，说是那一箱什么匣子里装着，我按着老太太的话一拿就拿出来了	丫头
邢王二夫人凤姐等请安，见[E2]精神尚好，不过叫人告诉[E1]，立刻来请了安	儿子
[E1]着急，知病难医，即命人到衙门告假，日夜同[E2]亲视汤药	丈夫
[E2]着急，知病难医，即命人到衙门告假，日夜同[E1]亲视汤药	妻
只见老婆子在门外探头，[E2]叫[E1]看去，问问是谁	大丫头
”[E2]在内已听见了，恐老太太听见不受用，忙叫[E1]带他外头说去	大丫头
”[E2]便叫[E1]叫这婆子去回大太太去，那婆子去了	大丫头
那时宝钗李氏等不在房中，凤姐近来有病，[E2]恐贾母生悲添病，便叫人叫了他们来陪着，自己回到房中，叫[E1]来埋怨这婆子不懂事，“以后我在老太太那里，你们有事不用来回	大丫头
那时宝钗李氏等不在房中，凤姐近来有病，[E1]恐[E2]生悲添病，便叫人叫了他们来陪着，自己回到房中，叫彩云来埋怨这婆子不懂事，“以后我在老太太那里，你们有事不用来回	小儿媳
那时宝钗李氏等不在房中，凤姐近来有病，王夫人恐[E1]生悲添病，便叫人叫了他们来陪着，自己回到房中，叫[E2]来埋怨这婆子不懂事，“以后我在老太太那里，你们有事不用来回	无关系
.. ”琥珀也不便回，心里打算告诉[E1]，叫他撒谎去，所以来到[E2]床前，只见[E2]神色大变，地下站着一屋子的人，嘁嘁的说“瞧着是不好了”，也不敢言语了	丫头
贾琏先回到[E2]房里，向[E1]悄悄的回道：“诸事已交派明白了	儿子
[E1]先回到[E2]房里，向贾政悄悄的回道：“诸事已交派明白了	无关系
[E2]睁眼要茶喝，[E1]便进了一杯参汤	大儿媳
[E1]睁眼要茶喝，[E2]便进了一杯参汤	婆婆
王夫人宝钗上去轻轻扶着，[E1]凤姐等便忙穿衣，地下婆子们已将床安设停当，铺了被褥，听见[E2]喉间略一响动，脸变笑容，竟是去了，享年八十三岁	大儿媳
王夫人宝钗上去轻轻扶着，[E2]凤姐等便忙穿衣，地下婆子们已将床安设停当，铺了被褥，听见[E1]喉间略一响动，脸变笑容，竟是去了，享年八十三岁	婆婆
[E1]宝钗上去轻轻扶着，邢夫人凤姐等便忙穿衣，地下婆子们已将床安设停当，铺了被褥，听见[E2]喉间略一响动，脸变笑容，竟是去了，享年八十三岁	小儿媳
[E1]宝钗上去轻轻扶着，[E2]凤姐等便忙穿衣，地下婆子们已将床安设停当，铺了被褥，听见贾母喉间略一响动，脸变笑容，竟是去了，享年八十三岁	无关系
贾赦不在家，[E1]为长，宝玉，[E2]，贾兰是亲孙，年纪又小，都应守灵	父亲
[E2]不在家，[E1]为长，宝玉，贾环，贾兰是亲孙，年纪又小，都应守灵	兄弟
贾赦不在家，[E2]为长，宝玉，[E1]，贾兰是亲孙，年纪又小，都应守灵	儿子
贾赦不在家，贾政为长，宝玉，[E1]，[E2]是亲孙，年纪又小，都应守灵	无关系
[E1]不在家，贾政为长，宝玉，贾环，[E2]是亲孙，年纪又小，都应守灵	无关系
[E1]不在家，贾政为长，宝玉，[E2]，贾兰是亲孙，年纪又小，都应守灵	无关系
虽请了些男女外亲来照应，内里邢王二夫人、李纨、凤姐、宝钗等是应灵旁哭泣的，[E1]虽可照应，他[E2]外出依住荣府，一向总不上前，且又荣府的事不甚谙练	妻
虽请了些男女外亲来照应，内里邢王二夫人、李纨、凤姐、宝钗等是应灵旁哭泣的，[E2]虽可照应，他[E1]外出依住荣府，一向总不上前，且又荣府的事不甚谙练	丈夫
”凤姐一想不差，转身就走，只得到[E2]那边找了玉钏[E1]，才拿了一分出来，急忙叫彩明登帐，发与众人收管	大丫头
”凤姐一想不差，转身就走，只得到[E1]那边找了[E2]，才拿了一分出来，急忙叫彩明登帐，发与众人收管	无关系
况且老太太的事原是长房作主，[E2]虽不在家，[E1]又是拘泥的人，有件事便说请大奶奶的主意	兄弟
[E1]只道已将这项银两交了出去了，故见凤姐掣肘如此，便疑为不肯用心，便在[E2]灵前唠唠叨叨哭个不了	丫头
且说[E1]因他女婿病着，[E2]死后只来的一次，屈指算是后日送殡，不能不去	孙女
这里琥珀辞了灵，听邢王二夫人分派看家的人，想着去问[E1]明日怎样坐车的，在[E2]的外间屋里找了一遍不见，便找到套间里头	丫头
[E1]因他为[E2]而死，要了香来上了三炷，作了一个揖，说：“他是殉葬的人，不可作丫头论	儿子
且说包勇自被[E1]吆喝派去看园，[E2]的事出来也忙了，不曾派他差使，他也不理会，总是自做自吃，闷来睡一觉，醒时便在园里耍刀弄棍，倒也无拘无束	儿子
[E1]等在[E2]灵前辞别，众人又哭了一场	儿子
寺里只有[E1]、[E2]、鹦鹉等人	母亲
寺里只有[E2]、[E1]、鹦鹉等人	儿子
众人只顾[E2]，谁料理[E1]	母亲
众人只顾[E1]，谁料理[E2]	儿子
”[E1]儿便走到跟前，[E2]忙着拉着道：“阿弥陀佛，不要折杀我了	被抚养
”拉着[E2]到下房坐着，青儿在[E1]儿那边	被抚养
那甄老爷即是[E1]之父，名叫[E2]，表字友忠，也是金陵人氏，功勋之后	儿子
那甄宝玉依命前行，[E2]等陪着来见[E1]	母亲
那甄宝玉依命前行，[E1]等陪着来见[E2]	儿子
那[E1]依命前行，[E2]等陪着来见王夫人	无关系
那[E1]依命前行，贾宝玉等陪着来见[E2]	无关系
[E2]等只得陪着来到书房，见[E1]已在那里，复又立谈几句	父亲
[E1]等只得陪着来到书房，见[E2]已在那里，复又立谈几句	儿子
一日，[E2]因为惜春定要绞发出家，尤氏不能拦阻，看着惜春的样子是若不依他必要自尽的，虽然昼夜着人看着，终非常事，便告诉了[E1]	丈夫
一日，[E1]因为惜春定要绞发出家，尤氏不能拦阻，看着惜春的样子是若不依他必要自尽的，虽然昼夜着人看着，终非常事，便告诉了[E2]	妻
一日，[E1]因为惜春定要绞发出家，[E2]不能拦阻，看着惜春的样子是若不依他必要自尽的，虽然昼夜着人看着，终非常事，便告诉了贾政	无关系
一日，王夫人因为惜春定要绞发出家，[E1]不能拦阻，看着惜春的样子是若不依他必要自尽的，虽然昼夜着人看着，终非常事，便告诉了[E2]	无关系
”[E1]略略一看，知道此事有些根源，也不细看，便和[E2]道：“宝玉好过来了	丈夫
”[E2]略略一看，知道此事有些根源，也不细看，便和[E1]道：“宝玉好过来了	妻
”[E2]只道旧病复发，便好延医调治，即命丫头婆子快去告诉[E1]，说是“宝玉回过来了，头里原是心迷住了，如今说出话来，不用备办后事了	丈夫
”[E1]只道旧病复发，便好延医调治，即命丫头婆子快去告诉[E2]，说是“宝玉回过来了，头里原是心迷住了，如今说出话来，不用备办后事了	妻
便是[E1]见宝玉已好，现在丁忧无事，想起[E2]不知几时遇赦，老太太的灵柩久停寺内，终不放心，欲要扶柩回南安葬，便叫了贾琏来商议	兄弟
便是贾政见宝玉已好，现在丁忧无事，想起[E2]不知几时遇赦，老太太的灵柩久停寺内，终不放心，欲要扶柩回南安葬，便叫了[E1]来商议	儿子
便是贾政见宝玉已好，现在丁忧无事，想起[E1]不知几时遇赦，老太太的灵柩久停寺内，终不放心，欲要扶柩回南安葬，便叫了[E2]来商议	父亲
便是[E1]见宝玉已好，现在丁忧无事，想起贾赦不知几时遇赦，老太太的灵柩久停寺内，终不放心，欲要扶柩回南安葬，便叫了[E2]来商议	无关系
[E1]便告诉了[E2]，叫他管了家，自己便择了发引长行的日子，就要起身	丈夫
[E2]便告诉了[E1]，叫他管了家，自己便择了发引长行的日子，就要起身	妻
宝玉此时身体复元，[E2]贾兰倒认真念书，[E1]都交付给贾琏，叫他管教，“今年是大比的年头	父亲
宝玉此时身体复元，[E1]贾兰倒认真念书，[E2]都交付给贾琏，叫他管教，“今年是大比的年头	儿子
宝玉此时身体复元，贾环贾兰倒认真念书，[E1]都交付给[E2]，叫他管教，“今年是大比的年头	无关系
宝玉此时身体复元，[E1][E2]倒认真念书，贾政都交付给贾琏，叫他管教，“今年是大比的年头	无关系
宝玉因[E1]命他赴考，[E2]便不时催逼查考起他的工课来	丈夫
宝玉因[E2]命他赴考，[E1]便不时催逼查考起他的工课来	妻
只有[E2]儿惨伤的了不得，[E1]又欲托王仁照应，[E2]到底不愿意，听见外头托了芸蔷二人，心里更不受用，嘴里却说不出来，只得送了他父亲，谨谨慎慎的随着平儿过日子	父亲
只有[E1]儿惨伤的了不得，[E2]又欲托王仁照应，[E1]到底不愿意，听见外头托了芸蔷二人，心里更不受用，嘴里却说不出来，只得送了他父亲，谨谨慎慎的随着平儿过日子	女儿
那[E2]为他父亲不在家，[E1]已死，王夫人不大理会他，便入了贾蔷一路	母亲
那[E1]为他父亲不在家，[E2]已死，王夫人不大理会他，便入了贾蔷一路	儿子
那贾环为他父亲不在家，赵姨娘已死，[E1]不大理会他，便入了[E2]一路	无关系
那贾环为他父亲不在家，[E1]已死，王夫人不大理会他，便入了[E2]一路	无关系
[E2]是素来沉静，除了请王夫人的安，会会宝钗，余者一步不走，只有看着[E1]攻书	儿子
李纨是素来沉静，除了请[E1]的安，会会宝钗，余者一步不走，只有看着[E2]攻书	无关系
且言[E1]扶了[E2]灵柩一路南行，因遇着班师的兵将船只过境，河道拥挤，不能速行，在道实在心焦	儿子
[E2]本是一个钱没有的，虽是[E1]积蓄些微，早被他弄光了，那能照应人家	母亲
[E1]本是一个钱没有的，虽是[E2]积蓄些微，早被他弄光了，那能照应人家	儿子
便想起凤姐待他刻薄，要趁[E1]不在家要摆布[E2]出气，遂把这个当叫贾芸来上，故意的埋怨贾芸道：“你们年纪又大，放着弄银钱的事又不敢办，倒和我没有钱的人相商	父亲
便想起凤姐待他刻薄，要趁[E2]不在家要摆布[E1]出气，遂把这个当叫贾芸来上，故意的埋怨贾芸道：“你们年纪又大，放着弄银钱的事又不敢办，倒和我没有钱的人相商	女儿
[E2]因向[E1]道：“哥儿瞧见了	儿子
王夫人便骂[E2]说：“[E1]这样混帐的东西，留的种子也是这混帐的	母亲
王夫人便骂[E1]说：“[E2]这样混帐的东西，留的种子也是这混帐的	儿子
[E1]便骂[E2]说：“赵姨娘这样混帐的东西，留的种子也是这混帐的	无关系
[E1]便骂贾环说：“[E2]这样混帐的东西，留的种子也是这混帐的	无关系
于是[E2]、[E1]、史湘云、宝琴、李婶等，连二连三的过来请安问信	侄儿
于是薛姨妈、[E1]、[E2]、宝琴、李婶等，连二连三的过来请安问信	无关系
那知[E1]随了[E2]带着平儿出了城，到了庄上，[E2]也不敢轻亵[E1]，便打扫上房让给[E1]平儿住下	被抚养
[E2]听说，喜的眉开眼笑，去和[E1]儿贺喜，将板儿的话说了一遍	被抚养
”[E2]听了得意，便叫人赶了两辆车，请[E1]平儿上车	被抚养
[E1]等在[E2]家住熟了，反是依依不舍，更有青儿哭着，恨不能留下	被抚养
且说[E1]先前知道[E2]病重，赶到配所，父子相见，痛哭了一场，渐渐的好起来	儿子
且说[E2]先前知道[E1]病重，赶到配所，父子相见，痛哭了一场，渐渐的好起来	父亲
[E1]接着家书，知道家中的事，禀明[E2]回来，走到中途，听得大赦，又赶了两天，今日到家，恰遇颁赏恩旨	儿子
[E2]接着家书，知道家中的事，禀明[E1]回来，走到中途，听得大赦，又赶了两天，今日到家，恰遇颁赏恩旨	父亲
[E1]早知道是[E2]来的车，便骂家人道：“你们这班糊涂忘八崽子，我不在家，就欺心害主，将[E2]儿都逼走了	父亲
[E2]早知道是[E1]来的车，便骂家人道：“你们这班糊涂忘八崽子，我不在家，就欺心害主，将[E1]儿都逼走了	女儿
自此[E1]心里愈敬平儿，打算等[E2]等回来要扶平儿为正	儿子
自此[E2]心里愈敬平儿，打算等[E1]等回来要扶平儿为正	父亲
邢夫人正恐[E1]不见了[E2]，必有一番的周折，又听见[E1]在王夫人那里，心下更是着急，便叫丫头去打听	父亲
邢夫人正恐[E2]不见了[E1]，必有一番的周折，又听见[E2]在王夫人那里，心下更是着急，便叫丫头去打听	女儿
邢夫人正恐贾琏不见了[E1]，必有一番的周折，又听见贾琏在[E2]那里，心下更是着急，便叫丫头去打听	无关系
[E1]正恐贾琏不见了[E2]，必有一番的周折，又听见贾琏在王夫人那里，心下更是着急，便叫丫头去打听	无关系
回来说是[E1]儿同着[E2]在那里说话，邢夫人才如梦初觉，知他们的鬼，还抱怨着王夫人“调唆我母子不和，到底是那个送信给平儿的	被抚养
回来说是[E1]儿同着刘姥姥在那里说话，[E2]才如梦初觉，知他们的鬼，还抱怨着王夫人“调唆我母子不和，到底是那个送信给平儿的	无关系
”正问着，只见[E1]同着[E2]带了平儿，王夫人在后头跟着进来，先把头里的话都说在贾芸王仁身上，说：“大太太原是听见人说，为的是好事，那里知道外头的鬼	被抚养
”正问着，只见[E1]同着刘姥姥带了平儿，[E2]在后头跟着进来，先把头里的话都说在贾芸王仁身上，说：“大太太原是听见人说，为的是好事，那里知道外头的鬼	无关系
且说[E1]扶[E2]灵柩，贾蓉送了秦氏凤姐鸳鸯的棺木，到了金陵，先安了葬	儿子
且说贾政扶[E2]灵柩，贾蓉送了秦氏凤姐[E1]的棺木，到了金陵，先安了葬	丫头
且说[E1]扶贾母灵柩，贾蓉送了秦氏凤姐[E2]的棺木，到了金陵，先安了葬	无关系
且说贾政扶[E1]灵柩，[E2]送了秦氏凤姐鸳鸯的棺木，到了金陵，先安了葬	无关系
且说[E2]得了赦罪的信，便命[E1]去各处借贷	侄儿
[E1]便要去拜谢贾家，[E2]宝钗也都过来	儿子
[E2]便要去拜谢贾家，[E1]宝钗也都过来	母亲
贾兰念到[E1]亲见宝玉的一段，众人听了都痛哭起来，[E2]宝钗袭人等更甚	丈夫
贾兰念到[E2]亲见宝玉的一段，众人听了都痛哭起来，[E1]宝钗袭人等更甚	妻
[E1]念到贾政亲见宝玉的一段，众人听了都痛哭起来，王夫人宝钗[E2]等更甚	无关系
[E1]念到贾政亲见宝玉的一段，众人听了都痛哭起来，[E2]宝钗袭人等更甚	无关系
”[E2]哭着和[E1]道：“宝玉抛了我，我还恨他呢	姐妹
”[E1]哭着和[E2]道：“宝玉抛了我，我还恨他呢	姐妹
”[E2]被[E1]一番言语说得极有理，心想：“宝钗小时候更是廉静寡欲极爱素淡的，他所以才有这个事，想人生在世真有一定数的	姐妹
”[E1]被[E2]一番言语说得极有理，心想：“宝钗小时候更是廉静寡欲极爱素淡的，他所以才有这个事，想人生在世真有一定数的	姐妹
[E1]心里反倒安了，便到[E2]那里先把宝钗的话说了	姐妹
[E2]心里反倒安了，便到[E1]那里先把宝钗的话说了	姐妹
[E1]见[E2]贾珍已都回家，弟兄叔侄相见，大家历叙别来的景况	兄弟
贾政见[E1][E2]已都回家，弟兄叔侄相见，大家历叙别来的景况	无关系
[E1]也趁便回说：“[E2]亲事，父亲太太都愿意给周家为媳	父亲
[E2]也趁便回说：“[E1]亲事，父亲太太都愿意给周家为媳	女儿
[E2]便告诉了宝钗，仍请了[E1]细细的告诉了袭人	姐妹
[E1]便告诉了宝钗，仍请了[E2]细细的告诉了袭人	姐妹
王夫人便告诉了宝钗，仍请了[E1]细细的告诉了[E2]	无关系
[E1]便告诉了宝钗，仍请了薛姨妈细细的告诉了[E2]	无关系
[E2]看了，方知这姓蒋的原来就是[E1]，始信姻缘前定	夫妻
[E2]才将心事说出，[E1]也深为叹息敬服，不敢勉强，并越发温柔体贴，弄得个[E2]真无死所了	夫妻
